"date","vn","av","sb","rv","oc","ie","la","inbound","weekend_d"
2016-01-01,0,649,926,0,0,0,0,1575,0
2016-01-02,0,1449,2576,0,1371,230,271,5897,1
2016-01-03,0,1260,1538,0,866,126,191,3981,1
2016-01-04,1633,2841,5793,2302,3764,2171,1210,19714,0
2016-01-05,1721,2549,5498,2643,4534,2147,1356,20448,0
2016-01-06,1771,2842,5576,2424,4381,2234,1512,20740,0
2016-01-07,1706,2580,5531,2487,4180,2184,1191,19859,0
2016-01-08,1568,2965,5040,2065,4000,1960,1306,18904,0
2016-01-09,0,1848,1563,0,995,131,269,4806,1
2016-01-10,0,1520,1079,0,785,115,168,3667,1
2016-01-11,1886,2521,6014,2512,4097,2323,1296,20649,0
2016-01-12,1728,2959,5806,2616,4222,2209,1324,20864,0
2016-01-13,1748,2855,5944,2088,3885,2280,1336,20136,0
2016-01-14,1984,2914,5235,1954,4013,2318,1420,19838,0
2016-01-15,1546,2537,4785,2035,3653,1589,1424,17569,0
2016-01-16,0,1512,1961,0,1117,182,252,5024,1
2016-01-17,0,1367,1437,0,796,112,201,3913,1
2016-01-18,402,1919,2998,1016,2119,1523,497,10474,0
2016-01-19,1946,2519,5858,2131,4064,2520,1089,20127,0
2016-01-20,1475,2894,6069,2506,4389,2551,1179,21063,0
2016-01-21,1696,2792,5952,2545,4302,2517,1366,21170,0
2016-01-22,1623,2993,5119,2290,4260,2247,1107,19639,0
2016-01-23,0,1504,2508,0,1240,178,523,5953,1
2016-01-24,0,1541,1234,0,548,206,213,3742,1
2016-01-25,1860,2899,5876,2512,4045,2248,1325,20765,0
2016-01-26,1400,2464,5365,2505,4344,2425,1332,19835,0
2016-01-27,1856,2987,5734,2413,3861,2510,1481,20842,0
2016-01-28,1765,2907,5399,2567,4183,2375,1269,20465,0
2016-01-29,1271,2994,4802,2342,4115,2106,1160,18790,0
2016-01-30,0,1349,2202,0,1189,161,314,5215,1
2016-01-31,0,1323,799,0,499,89,153,2863,1
2017-01-01,0,915,1071,0,898,109,117,3110,1
2017-01-02,0,1144,1023,0,535,117,154,2973,0
2017-01-03,1619,2734,4444,2252,4254,1967,1051,18321,0
2017-01-04,1660,2877,4530,1783,3881,2332,1215,18278,0
2017-01-05,1675,2755,4254,2204,4714,2290,1188,19080,0
2017-01-06,1294,3000,3918,1965,3735,2134,1278,17324,0
2017-01-07,0,1170,1536,0,970,122,245,4043,1
2017-01-08,0,1137,1075,0,747,130,185,3274,1
2017-01-09,1530,2651,4246,2052,4854,2299,1179,18811,0
2017-01-10,1665,3073,4590,2426,4608,2027,1267,19656,0
2017-01-11,1807,2895,4002,2245,4297,2368,1448,19062,0
2017-01-12,1674,2761,4707,2227,4003,2447,1341,19160,0
2017-01-13,1455,2790,4010,1914,3834,2133,1229,17365,0
2017-01-14,0,1245,1928,0,1431,139,359,5102,1
2017-01-15,0,985,1268,0,802,147,216,3418,1
2017-01-16,671,1810,2081,908,2488,1453,440,9851,0
2017-01-17,1734,3192,4431,2404,4579,2332,1363,20035,0
2017-01-18,1602,3062,4548,2542,4323,2174,1022,19273,0
2017-01-19,1668,3025,4667,2420,3980,2324,2026,20110,0
2017-01-20,1530,2529,3949,2126,3599,2285,1209,17227,0
2017-01-21,0,2438,4389,0,1264,137,335,8563,1
2017-01-22,0,821,814,0,499,87,133,2354,1
2017-01-23,1650,2705,4189,2316,4301,2116,1271,18548,0
2017-01-24,1865,2940,5061,2277,4146,2393,1286,19968,0
2017-01-25,1796,3054,5123,2294,4084,3554,1308,21213,0
2017-01-26,1790,2906,4800,2299,4318,2359,1277,19749,0
2017-01-27,1475,2947,4610,2067,4168,2054,1553,18874,0
2017-01-28,0,1307,2270,0,1202,155,250,5184,1
2017-01-29,0,1274,1793,0,777,129,222,4195,1
2017-01-30,1588,3089,4638,1919,4515,2366,1198,19313,0
2017-01-31,1841,3205,4968,2529,4288,2424,1147,20402,0
2018-01-01,0,749,937,0,356,87,394,2523,0
2018-01-02,1431,2810,3882,1899,3468,2107,1164,16761,0
2018-01-03,1695,2877,4494,2398,3606,2191,1232,18493,0
2018-01-04,1645,2959,4435,2294,3990,2049,1266,18638,0
2018-01-05,1438,3064,3986,2081,3631,3683,1358,19241,0
2018-01-06,0,1365,2090,0,949,172,300,4876,1
2018-01-07,0,1091,1034,0,518,141,185,2969,1
2018-01-08,1705,2901,4414,2310,4336,2182,1392,19240,0
2018-01-09,1501,2799,4080,2245,3955,2074,1347,18001,0
2018-01-10,989,3080,4188,2225,1850,1879,2571,16782,0
2018-01-11,1786,2960,4208,2317,4235,2120,1343,18969,0
2018-01-12,1452,2849,3881,2114,3718,2077,1463,17554,0
2018-01-13,0,1220,1702,0,840,248,399,4409,1
2018-01-14,0,974,1129,0,751,209,243,3306,1
2018-01-15,651,1798,1996,693,1870,1174,610,8792,0
2018-01-16,1733,3133,4370,2367,3068,2164,1863,18698,0
2018-01-17,1818,3061,4461,2194,4083,2363,1530,19510,0
2018-01-18,1619,3266,4646,2274,3873,2245,1392,19315,0
2018-01-19,1524,3165,4199,2102,3464,2021,1350,17825,0
2018-01-20,117,2041,2944,0,892,136,713,6843,1
2018-01-21,0,943,1211,0,565,57,163,2939,1
2018-01-22,1640,2597,4650,2296,4319,2104,1254,18860,0
2018-01-23,1723,2672,4874,2550,4212,2066,1340,19437,0
2018-01-24,1839,2720,4785,2413,4073,2313,1439,19582,0
2018-01-25,1807,3159,4918,2277,4150,2048,1481,19840,0
2018-01-26,1584,2851,4485,2204,3884,2114,1240,18362,0
2018-01-27,0,1267,2367,0,913,163,452,5162,1
2018-01-28,0,1094,1616,0,882,211,241,4044,1
2018-01-29,1824,3211,4777,2159,3782,2060,1356,19169,0
2018-01-30,1815,3142,4950,2291,4148,2253,1386,19985,0
2018-01-31,1874,3187,4972,2017,4098,2213,1299,19660,0
2019-01-01,0,764,1150,0,501,106,89,2610,0
2019-01-02,1235,2359,3877,1791,3512,1857,1184,15815,0
2019-01-03,1354,2581,4346,1960,3592,1983,1079,16895,0
2019-01-04,1278,2755,3851,1775,2997,1996,920,15572,0
2019-01-05,0,1170,1836,0,840,172,297,4315,1
2019-01-06,0,925,1137,0,834,141,221,3258,1
2019-01-07,1562,2808,4064,2328,4125,2234,715,17836,0
2019-01-08,1676,2880,4690,2421,3772,2297,1214,18950,0
2019-01-09,1707,2946,4486,2255,4091,2297,1000,18782,0
2019-01-10,1574,2943,4197,2232,3964,2598,954,18462,0
2019-01-11,1401,2837,4476,2042,3662,2252,943,17613,0
2019-01-12,0,1165,2069,0,962,115,374,4685,1
2019-01-13,0,1010,1232,0,598,91,213,3144,1
2019-01-14,1534,2653,4122,2417,4034,2422,1140,18322,0
2019-01-15,1509,3033,4134,2160,4118,2243,1071,18268,0
2019-01-16,1502,2758,4604,2398,4233,2331,1310,19136,0
2019-01-17,1674,2027,4406,2305,4235,2444,1082,18173,0
2019-01-18,1282,2892,4355,1702,4165,1870,1306,17572,0
2019-01-19,144,1789,2737,0,1272,178,615,6735,1
2019-01-20,0,907,1369,0,922,167,226,3591,1
2019-01-21,587,1990,2093,716,1766,1559,445,9156,0
2019-01-22,1613,2962,4949,2115,4158,2290,1069,19156,0
2019-01-23,1617,2795,5279,2213,4168,2266,1391,19729,0
2019-01-24,1603,2774,5308,2217,3844,2439,1015,19200,0
2019-01-25,1475,3014,5019,1903,3791,2339,1384,18925,0
2019-01-26,0,1162,1423,0,1126,210,382,4303,1
2019-01-27,0,948,1386,0,767,131,185,3417,1
2019-01-28,1449,2893,4994,2312,4228,2364,1467,19707,0
2019-01-29,1610,3011,5103,2410,4134,2304,1223,19795,0
2019-01-30,1630,2766,4942,2191,4127,2344,1426,19426,0
2019-01-31,1272,2712,5079,2263,4160,4680,1326,21492,0
2020-01-01,0,760,970,0,672,141,208,2751,0
2020-01-02,1154,2486,3952,2116,3728,1324,933,15693,0
2020-01-03,1198,2456,4140,1872,3288,1446,968,15368,0
2020-01-04,0,1243,2262,0,1120,257,471,5353,1
2020-01-05,0,988,1373,0,771,160,311,3603,1
2020-01-06,1472,2928,4712,2457,4132,1772,1359,18832,0
2020-01-07,1616,2852,4579,2308,4218,2102,1529,19204,0
2020-01-08,1354,5212,4665,2326,4434,2318,1498,21807,0
2020-01-09,1812,2887,4403,2491,4496,2402,1565,20056,0
2020-01-10,1428,2844,4018,2228,3859,2328,1438,18143,0
2020-01-11,0,1157,1582,0,736,110,614,4199,1
2020-01-12,0,946,1362,0,806,125,271,3510,1
2020-01-13,1701,2982,4806,1804,4060,2123,1397,18873,0
2020-01-14,1724,2881,4850,2366,3866,2341,1435,19463,0
2020-01-15,1578,2887,5177,2479,3910,2044,1527,19602,0
2020-01-16,1518,2958,4712,2362,4282,2371,1409,19612,0
2020-01-17,1397,3151,4483,2300,3774,2347,1422,18874,0
2020-01-18,81,1471,2620,0,1108,230,1010,6520,1
2020-01-19,0,931,1408,0,989,229,337,3894,1
2020-01-20,735,1849,2298,679,1740,1425,458,9184,0
2020-01-21,1975,2961,5141,2357,3975,2308,1601,20318,0
2020-01-22,1706,2946,5325,2216,4132,2443,1381,20149,0
2020-01-23,1862,2859,5573,2062,3790,2755,1663,20564,0
2020-01-24,1270,2665,4865,2253,4244,2306,1345,18948,0
2020-01-25,0,1120,2241,0,1122,294,479,5256,1
2020-01-26,0,914,1432,0,1046,233,268,3893,1
2020-01-27,1758,2944,5351,2276,4549,2333,1628,20839,0
2020-01-28,1762,2796,5594,2426,4479,2642,1322,21021,0
2020-01-29,1969,2853,5515,2276,3871,2436,1611,20531,0
2020-01-30,1621,3145,5285,2128,3858,2444,1459,19940,0
2020-01-31,1689,2975,4792,2214,3438,2175,1573,18856,0
2016-02-01,1634,3694,5014,1978,3600,2373,1248,19541,0
2016-02-02,1807,2882,4695,2603,4242,2491,948,19668,0
2016-02-03,1469,2898,5675,2573,4230,2615,1395,20855,0
2016-02-04,1940,3272,5490,1979,3833,2393,1295,20202,0
2016-02-05,1687,3053,5588,2450,3886,2318,1320,20302,0
2016-02-06,0,1464,2213,0,1141,291,355,5464,1
2016-02-07,0,1014,1237,0,752,143,123,3269,1
2016-02-08,1797,3136,5215,2341,4211,2559,1217,20476,0
2016-02-09,2126,3000,5788,2409,4328,2324,1414,21389,0
2016-02-10,1782,3127,5733,2098,4246,1685,1409,20080,0
2016-02-11,1838,3219,5508,2417,4356,2536,1475,21349,0
2016-02-12,1660,2897,5285,2302,4028,2091,1154,19417,0
2016-02-13,0,1799,2937,0,2125,455,620,7936,1
2016-02-14,0,1250,1125,0,1013,673,333,4394,1
2016-02-15,700,2057,3128,821,1797,1353,338,10194,0
2016-02-16,1801,3171,5521,2164,4028,1933,980,19598,0
2016-02-17,1852,3067,5649,2572,4229,2403,1298,21070,0
2016-02-18,1751,3022,5693,2567,4010,2800,1068,20911,0
2016-02-19,1736,3156,5307,2301,3575,2365,1076,19516,0
2016-02-20,0,1410,2094,0,1368,635,682,6189,1
2016-02-21,0,1043,1324,0,1143,597,481,4588,1
2016-02-22,1935,2898,5622,2515,4146,1883,927,19926,0
2016-02-23,1627,3068,5214,1838,3403,2549,878,18577,0
2016-02-24,1395,2985,5321,2431,3156,2351,1174,18813,0
2016-02-25,1472,2907,5244,2441,3827,2424,1474,19789,0
2016-02-26,1520,3274,5302,2506,3647,2052,1170,19471,0
2016-02-27,0,1391,2498,0,1436,418,146,5889,1
2016-02-28,0,1270,1416,0,1072,423,102,4283,1
2016-02-29,1800,2991,5222,2676,4039,2250,1519,20497,0
2017-02-01,1730,3218,4924,2227,4465,2499,1073,20136,0
2017-02-02,2000,3174,4912,2204,4165,2485,1145,20085,0
2017-02-03,1544,2881,4822,2181,3475,2235,1214,18352,0
2017-02-04,0,1543,2317,0,1651,166,336,6013,1
2017-02-05,0,939,921,0,752,101,171,2884,1
2017-02-06,1508,3044,4636,2117,4323,2247,972,18847,0
2017-02-07,1735,3308,4803,2023,4155,2480,1214,19718,0
2017-02-08,1695,3175,4753,2359,4087,2534,1314,19917,0
2017-02-09,1858,3215,4758,2322,4480,2376,1173,20182,0
2017-02-10,1574,2581,4688,2262,3529,2321,1126,18081,0
2017-02-11,0,1408,1546,0,1168,277,252,4651,1
2017-02-12,0,1129,1335,0,874,238,177,3753,1
2017-02-13,1635,3140,5037,2215,3251,2165,1154,18597,0
2017-02-14,1866,2980,5002,2289,3871,2146,1493,19647,0
2017-02-15,1791,3070,4949,2631,4094,2448,1460,20443,0
2017-02-16,1695,2984,4478,2346,3805,2476,1519,19303,0
2017-02-17,1462,2536,4051,2038,3367,2052,1148,16654,0
2017-02-18,0,979,1578,0,849,120,269,3795,1
2017-02-19,0,1137,1313,0,978,141,255,3824,1
2017-02-20,611,1795,2169,969,1916,1274,652,9386,0
2017-02-21,1759,3086,4746,2247,4165,2371,1413,19787,0
2017-02-22,2029,3071,4520,2316,4376,2478,1254,20044,0
2017-02-23,1857,3143,5004,2386,4209,2463,1368,20430,0
2017-02-24,1444,3113,4571,2238,3685,2090,1315,18456,0
2017-02-25,0,1601,2024,0,1198,158,350,5331,1
2017-02-26,0,1125,1237,0,800,167,150,3479,1
2017-02-27,1691,2978,4661,2305,4025,2276,1421,19357,0
2017-02-28,1897,3025,5001,2487,4093,2410,1345,20258,0
2018-02-01,1751,3293,4926,2269,3754,1815,1346,19154,0
2018-02-02,1655,3188,4970,2349,3724,1927,1569,19382,0
2018-02-03,0,1462,2003,0,771,130,307,4673,1
2018-02-04,0,1060,1291,0,527,77,224,3179,1
2018-02-05,2010,3045,4873,2219,4021,2146,1618,19932,0
2018-02-06,1813,3150,4798,2407,4180,2171,1310,19829,0
2018-02-07,1854,2992,4692,2448,3778,2280,1545,19589,0
2018-02-08,1742,3050,4730,2396,3956,2176,1430,19480,0
2018-02-09,1349,2995,4660,2107,3830,2373,1305,18619,0
2018-02-10,0,1421,1910,0,1034,168,441,4974,1
2018-02-11,0,1159,1528,0,823,181,141,3832,1
2018-02-12,1639,3109,4564,2274,4120,2126,1411,19243,0
2018-02-13,1690,3097,4826,2430,4074,2126,1418,19661,0
2018-02-14,1636,3063,4829,2458,4123,2113,1409,19631,0
2018-02-15,1237,3208,4716,2466,3953,2112,1367,19059,0
2018-02-16,1353,3265,4620,2109,3023,1950,1542,17862,0
2018-02-17,0,1686,2633,0,1906,283,533,7041,1
2018-02-18,0,1198,1358,0,861,263,245,3925,1
2018-02-19,642,1887,2410,657,1762,1303,583,9244,0
2018-02-20,1612,2993,4449,2402,4264,2124,1297,19141,0
2018-02-21,1566,2971,4841,2396,4166,2174,1514,19628,0
2018-02-22,1643,3061,5062,2504,4085,2007,1393,19755,0
2018-02-23,1548,3166,4617,2047,4020,1942,1428,18768,0
2018-02-24,0,1410,1824,0,853,109,342,4538,1
2018-02-25,0,1175,1433,0,889,200,240,3937,1
2018-02-26,1684,3044,4727,2251,4013,1934,1622,19275,0
2018-02-27,1570,2980,4703,2213,3899,1865,1190,18420,0
2018-02-28,1753,3116,4726,2336,3954,2117,1436,19438,0
2019-02-01,1303,2996,4674,1946,3510,2467,1265,18161,0
2019-02-02,0,932,1168,0,736,76,260,3172,1
2019-02-03,0,948,693,0,654,96,162,2553,1
2019-02-04,1507,2620,4983,2344,4244,2209,1425,19332,0
2019-02-05,1667,2889,4438,2363,4064,2229,1076,18726,0
2019-02-06,1703,2842,5320,2210,3661,2303,1509,19548,0
2019-02-07,1493,2823,5100,2300,3775,2381,1634,19506,0
2019-02-08,1606,2461,4883,1917,3796,1626,861,17150,0
2019-02-09,0,1232,2031,0,1163,113,689,5228,1
2019-02-10,0,857,901,0,471,73,137,2439,1
2019-02-11,1579,2790,4485,2173,4155,2281,1466,18929,0
2019-02-12,1700,2976,4789,2280,4142,2336,1342,19565,0
2019-02-13,1716,2928,5462,2339,4060,2331,1196,20032,0
2019-02-14,1583,3009,4826,2098,4002,1801,1527,18846,0
2019-02-15,1476,2782,4154,1959,3736,2284,1451,17842,0
2019-02-16,0,1117,1861,0,1190,185,539,4892,1
2019-02-17,0,758,757,0,794,132,189,2630,1
2019-02-18,629,1741,2775,645,1806,1430,547,9573,0
2019-02-19,1647,2498,4908,2360,4475,2359,1363,19610,0
2019-02-20,1566,3003,5238,2296,4058,2419,1346,19926,0
2019-02-21,1462,3080,5409,2273,3990,2202,1348,19764,0
2019-02-22,1346,2981,5069,2149,4022,2121,1133,18821,0
2019-02-23,0,1230,1981,0,1329,195,325,5060,1
2019-02-24,0,815,1306,0,845,207,200,3373,1
2019-02-25,1687,3075,5058,2412,3835,2325,1331,19723,0
2019-02-26,1687,2883,5136,2423,4237,2289,1217,19872,0
2019-02-27,1527,2933,5073,2314,4061,2274,1625,19807,0
2019-02-28,1683,2913,4930,2410,3938,2389,1310,19573,0
2020-02-01,0,1275,1584,0,1399,192,520,4970,1
2020-02-02,0,803,1175,0,613,143,269,3003,1
2020-02-03,1890,2610,5256,2305,4502,1987,1493,20043,0
2020-02-04,1680,2956,4930,2399,3689,2103,1564,19321,0
2020-02-05,1674,2806,5233,2345,4172,2087,1574,19891,0
2020-02-06,1803,2947,5601,2374,3775,2366,1458,20324,0
2020-02-07,1635,2976,4942,2156,3710,2214,1527,19160,0
2020-02-08,0,1368,1484,0,974,201,514,4541,1
2020-02-09,0,879,1033,0,597,138,203,2850,1
2020-02-10,1734,3044,5063,2410,4321,2116,1726,20414,0
2020-02-11,2572,3000,4952,2523,4017,2179,1743,20986,0
2020-02-12,1700,2863,5076,2422,4336,2037,1320,19754,0
2020-02-13,1858,3067,5462,2371,4303,2573,1557,21191,0
2020-02-14,1524,2942,4848,2362,3829,2003,1254,18762,0
2020-02-15,0,1243,2430,0,1322,202,503,5700,1
2020-02-16,0,1106,1474,0,1162,235,422,4399,1
2020-02-17,633,1676,2774,707,2186,1084,504,9564,0
2020-02-18,1755,2908,5197,2391,4443,2132,1515,20341,0
2020-02-19,1762,2889,5113,2354,4287,2054,1953,20412,0
2020-02-20,1722,3013,5794,2568,4294,2304,1535,21230,0
2020-02-21,1572,2944,5233,2074,4108,2283,1552,19766,0
2020-02-22,0,1058,1440,0,928,152,360,3938,1
2020-02-23,0,957,1246,0,957,171,275,3606,1
2020-02-24,1753,2964,4751,2402,4112,2311,1346,19639,0
2020-02-25,1928,2945,5275,2359,4274,2103,1537,20421,0
2020-02-26,1745,3067,5311,2532,4329,2303,1246,20533,0
2020-02-27,1908,3054,5418,2376,4116,2520,1385,20777,0
2020-02-28,1552,2952,4674,2168,3946,2307,1320,18919,0
2020-02-29,0,1154,1846,0,1049,232,522,4803,1
2016-03-01,1512,2983,5166,1847,4276,2455,1231,19470,0
2016-03-02,1819,3029,5338,1547,4169,2283,755,18940,0
2016-03-03,1777,3151,5177,2437,4105,2456,1418,20521,0
2016-03-04,1516,3147,4994,1878,3693,2106,797,18131,0
2016-03-05,0,1649,2009,0,1122,178,313,5271,1
2016-03-06,28,861,1314,0,407,181,181,2972,1
2016-03-07,1814,2705,5224,1806,3066,2045,1810,18470,0
2016-03-08,1918,2910,5182,1058,4097,2106,1479,18750,0
2016-03-09,1478,2994,5394,1341,3812,1898,1125,18042,0
2016-03-10,2049,2804,5713,2033,4150,1914,1324,19987,0
2016-03-11,1839,3041,5134,1760,3820,2479,1186,19259,0
2016-03-12,0,1557,1847,0,1685,542,312,5943,1
2016-03-13,0,1128,1351,0,917,218,263,3877,1
2016-03-14,1339,2911,4672,2206,3544,2259,1185,18116,0
2016-03-15,1421,2811,4588,1427,3741,2368,1357,17713,0
2016-03-16,1469,3087,4155,1178,3042,2526,1376,16833,0
2016-03-17,1606,2897,4687,2007,3350,2582,1683,18812,0
2016-03-18,2006,2894,4452,1917,3647,1722,1068,17706,0
2016-03-19,0,1528,2149,0,1459,643,116,5895,1
2016-03-20,0,1216,1563,0,966,272,284,4301,1
2016-03-21,1900,2885,4719,2251,4069,2609,1288,19721,0
2016-03-22,1997,3123,4916,1839,3027,2524,1259,18685,0
2016-03-23,1428,3105,4870,1647,3579,2554,1920,19103,0
2016-03-24,1650,2947,5116,2025,3774,2459,1434,19405,0
2016-03-25,1327,2832,4709,1618,3015,1956,920,16377,0
2016-03-26,0,1344,2047,0,1148,380,115,5034,1
2016-03-27,0,997,1110,0,978,371,102,3558,1
2016-03-28,1378,3292,5578,2194,4159,1602,1197,19400,0
2016-03-29,1524,2892,5546,2415,4271,2584,1236,20468,0
2016-03-30,1479,3194,5569,1841,3791,2451,1228,19553,0
2016-03-31,1615,2508,4851,2023,3440,2347,916,17700,0
2017-03-01,1985,2749,4918,2453,3859,2561,1282,19807,0
2017-03-02,1850,3242,4881,2375,3517,2429,1731,20025,0
2017-03-03,1714,3239,5031,2246,3975,2189,1149,19543,0
2017-03-04,0,1622,2306,0,1035,134,337,5434,1
2017-03-05,0,1026,992,0,748,126,157,3049,1
2017-03-06,1520,3076,5197,2328,4089,2291,1247,19748,0
2017-03-07,1792,3253,4859,2381,4023,2005,1485,19798,0
2017-03-08,1742,2529,5282,1781,4156,2520,1199,19209,0
2017-03-09,1566,3204,5361,919,4097,2623,1477,19247,0
2017-03-10,1518,3164,4898,2359,3790,2244,1306,19279,0
2017-03-11,0,1585,2183,0,1051,290,289,5398,1
2017-03-12,0,1315,1469,0,1137,271,219,4411,1
2017-03-13,1773,2786,4923,2294,4172,2380,1199,19527,0
2017-03-14,2120,3261,5004,2346,4037,2240,1259,20267,0
2017-03-15,2002,3149,5144,2408,4212,2227,1341,20483,0
2017-03-16,1829,3113,5071,2412,3993,2375,1310,20103,0
2017-03-17,1656,3093,4775,1519,3313,1927,1167,17450,0
2017-03-18,0,1005,2451,0,940,372,261,5029,1
2017-03-19,0,854,1421,0,908,219,270,3672,1
2017-03-20,1654,3258,4920,2470,4426,2168,1255,20151,0
2017-03-21,1813,3116,4751,2467,4079,2414,1095,19735,0
2017-03-22,1944,3045,4848,2549,4347,2345,1166,20244,0
2017-03-23,1728,3101,4960,2558,4065,2273,1464,20149,0
2017-03-24,1649,3115,3842,2442,3739,1757,1339,17883,0
2017-03-25,0,1540,2160,0,1324,506,301,5831,1
2017-03-26,0,1341,1242,0,1151,178,237,4149,1
2017-03-27,1511,2888,3712,2291,3836,1212,1016,16466,0
2017-03-28,1597,3046,4229,2508,4302,2083,1298,19063,0
2017-03-29,1538,2967,4675,2330,4446,2205,1212,19373,0
2017-03-30,1458,3072,3734,2371,4278,2125,1436,18474,0
2017-03-31,1265,2896,3829,1969,4170,1871,1007,17007,0
2018-03-01,1668,3158,5021,2360,4268,2173,1306,19954,0
2018-03-02,1278,3147,4742,2209,3450,1820,1285,17931,0
2018-03-03,0,1233,1637,0,677,100,337,3984,1
2018-03-04,0,1059,1107,0,671,125,238,3200,1
2018-03-05,1651,3085,4817,2486,3700,1858,1797,19394,0
2018-03-06,1552,3219,3902,2573,4129,2068,1383,18826,0
2018-03-07,1571,3022,4995,2433,4495,2162,1305,19983,0
2018-03-08,1445,2606,4601,1967,3442,2072,1010,17143,0
2018-03-09,1503,3228,4466,2126,3859,1994,1399,18575,0
2018-03-10,0,1275,1503,0,758,139,291,3966,1
2018-03-11,0,1077,1063,0,471,94,136,2841,1
2018-03-12,1815,2992,4912,2452,4466,2051,1336,20024,0
2018-03-13,1634,3241,4577,2335,4340,2027,1349,19503,0
2018-03-14,1856,3073,4745,2363,3782,2120,1425,19364,0
2018-03-15,1583,2976,4950,2484,4023,2131,1366,19513,0
2018-03-16,1582,2872,4696,2113,3720,1838,1317,18138,0
2018-03-17,0,1260,1762,0,893,138,289,4342,1
2018-03-18,0,1019,1270,0,924,211,178,3602,1
2018-03-19,1580,3164,4620,2237,4405,2032,1497,19535,0
2018-03-20,1651,3254,4826,2377,4583,2151,1344,20186,0
2018-03-21,1653,2872,4701,2403,4080,2053,1585,19347,0
2018-03-22,1383,2912,4611,2264,4011,2088,1215,18484,0
2018-03-23,1437,3050,4416,2111,2579,1853,1068,16514,0
2018-03-24,0,1564,2764,0,1300,578,388,6594,1
2018-03-25,0,828,1303,0,932,247,224,3534,1
2018-03-26,1668,2843,4149,1989,3755,2001,1046,17451,0
2018-03-27,1697,2848,4854,2413,4298,2066,1261,19437,0
2018-03-28,1539,2860,4901,2347,4185,2142,1535,19509,0
2018-03-29,1440,3010,5036,2020,4095,2172,1100,18873,0
2018-03-30,1076,2699,4064,1552,3369,1421,904,15085,0
2018-03-31,0,1313,2432,0,1107,343,264,5459,1
2019-03-01,1498,3057,5356,2087,3723,2233,1558,19512,0
2019-03-02,0,1020,979,0,547,106,278,2930,1
2019-03-03,0,1048,1227,0,659,161,197,3292,1
2019-03-04,1539,3108,5149,2269,4083,2617,1407,20172,0
2019-03-05,1612,3079,5332,2137,4339,2460,1335,20294,0
2019-03-06,1431,2783,5275,2302,3901,2201,1573,19466,0
2019-03-07,1720,3084,5126,2454,3976,2397,1212,19969,0
2019-03-08,1469,3049,4359,1963,3529,2159,1410,17938,0
2019-03-09,0,1294,1993,0,795,177,406,4665,1
2019-03-10,0,912,1198,0,775,110,209,3204,1
2019-03-11,1782,3104,5142,2113,4321,2253,1385,20100,0
2019-03-12,1708,2951,5200,2318,4147,2368,1363,20055,0
2019-03-13,1755,3114,5423,2204,4081,2328,1368,20273,0
2019-03-14,1527,2894,5240,2116,3948,2383,1370,19478,0
2019-03-15,1351,2911,4329,1933,3357,2273,1416,17570,0
2019-03-16,0,1237,2163,0,1172,503,350,5425,1
2019-03-17,0,941,1516,0,1262,401,259,4379,1
2019-03-18,1761,3094,5460,2335,4077,1984,1021,19732,0
2019-03-19,1688,2964,5318,2461,4458,2484,1503,20876,0
2019-03-20,1530,2639,5167,2107,3902,2351,1667,19363,0
2019-03-21,1592,2709,5355,2479,4014,2364,1488,20001,0
2019-03-22,1369,3068,5017,1929,3670,2025,1474,18552,0
2019-03-23,0,1288,2093,0,1588,1106,259,6334,1
2019-03-24,0,1005,1152,0,1343,383,392,4275,1
2019-03-25,1462,2841,5205,2094,4131,2444,1344,19521,0
2019-03-26,1492,3065,5624,2435,4045,2462,1244,20367,0
2019-03-27,1423,2921,5726,2384,4143,2382,1301,20280,0
2019-03-28,1559,2965,6355,2193,4228,2042,1281,20623,0
2019-03-29,1408,2980,5318,1893,3790,2287,1325,19001,0
2019-03-30,0,1226,2903,0,1561,615,509,6814,1
2019-03-31,0,1062,1424,0,1372,638,306,4802,1
2020-03-01,0,1134,1057,0,889,131,184,3395,1
2020-03-02,1548,2912,5147,2312,4273,2111,1227,19530,0
2020-03-03,1720,2823,5644,2265,4172,2170,1377,20171,0
2020-03-04,1638,2748,5427,2576,3905,2054,1077,19425,0
2020-03-05,1835,2764,5340,2362,3961,2590,1443,20295,0
2020-03-06,1504,2753,4741,1766,3738,2121,1161,17784,0
2020-03-07,0,977,1673,0,953,61,325,3989,1
2020-03-08,0,982,1073,0,640,133,231,3059,1
2020-03-09,1557,2699,5305,1968,3747,2081,1349,18706,0
2020-03-10,1513,2479,4858,2070,3754,1958,1213,17845,0
2020-03-11,1657,2689,5149,2159,3401,2250,1567,18872,0
2020-03-12,1363,2450,4317,2046,3235,2040,1139,16590,0
2020-03-13,856,2206,3426,1697,2622,1598,937,13342,0
2020-03-14,0,630,827,0,361,59,145,2022,1
2021-03-16,138,593,926,222,389,496,260,3024,0
2021-03-17,175,565,934,210,388,458,253,2983,0
2021-03-18,185,602,1005,207,481,488,262,3230,0
2021-03-19,174,604,977,188,457,472,280,3152,0
2021-03-20,0,491,725,0,171,62,146,1595,1
2021-03-21,0,398,434,0,181,34,88,1135,1
2021-03-22,196,683,1045,203,532,488,265,3412,0
2021-03-23,181,660,1056,221,554,506,292,3470,0
2021-03-24,212,647,1058,241,514,523,286,3481,0
2021-03-25,208,646,1061,209,542,419,249,3334,0
2021-03-26,170,627,1027,189,473,454,276,3216,0
2021-03-27,0,528,533,0,305,138,160,1664,1
2021-03-28,0,398,396,0,329,219,144,1486,1
2021-03-29,169,540,1074,204,489,459,250,3185,0
2021-03-30,203,642,1113,232,459,498,297,3444,0
2021-03-31,226,598,1014,200,484,459,289,3270,0
2016-04-01,1595,2934,5229,2260,3631,2117,1261,19027,0
2016-04-02,0,1478,2211,0,1697,704,316,6406,1
2016-04-03,0,1310,1548,0,1068,613,249,4788,1
2016-04-04,1808,2988,4722,1997,4650,1810,1484,19459,0
2016-04-05,1610,2707,4730,2001,4777,1816,1528,19169,0
2016-04-06,2016,2774,5954,1753,3803,1834,1386,19520,0
2016-04-07,1884,2948,4975,2505,3885,1864,901,18962,0
2016-04-08,1786,2767,4718,2187,4400,2369,1377,19604,0
2016-04-09,0,1046,2529,0,403,95,233,4306,1
2016-04-10,0,830,1844,0,518,138,157,3487,1
2016-04-11,1969,3022,5868,2252,3466,2449,1419,20445,0
2016-04-12,1883,2741,5570,2560,4311,2417,1432,20914,0
2016-04-13,1953,2877,5495,2416,4090,2462,1419,20712,0
2016-04-14,1750,3328,5553,2260,4340,2367,1396,20994,0
2016-04-15,1592,3232,5452,2220,3622,2286,1318,19722,0
2016-04-16,0,1372,2653,0,1302,364,319,6010,1
2016-04-17,0,1215,1865,0,846,276,218,4420,1
2016-04-18,1885,3021,5334,2208,4012,2137,1093,19690,0
2016-04-19,1860,3334,4927,1895,4204,1870,1261,19351,0
2016-04-20,1683,3100,5224,2318,3876,2320,1272,19793,0
2016-04-21,1955,2981,5023,2299,3244,2575,1333,19410,0
2016-04-22,1757,2893,4442,2112,5164,2357,1480,20205,0
2016-04-23,0,1172,1447,0,1166,322,285,4392,1
2016-04-24,0,1158,1269,0,1035,321,182,3965,1
2016-04-25,1879,2906,5133,2192,4323,2368,1192,19993,0
2016-04-26,1767,3053,5429,2091,4784,2525,1311,20960,0
2016-04-27,1528,2937,5193,2237,4737,2879,1319,20830,0
2016-04-28,1672,2839,5420,2230,4437,2433,1289,20320,0
2016-04-29,1479,3346,5186,2288,4212,2242,1298,20051,0
2016-04-30,0,1309,1745,0,1433,274,246,5007,1
2017-04-01,0,1089,1954,0,1170,310,324,4847,1
2017-04-02,0,1338,1497,0,1082,274,140,4331,1
2017-04-03,1684,2974,5090,2562,4588,2299,1454,20651,0
2017-04-04,1831,2385,5113,2434,4470,2407,1287,19927,0
2017-04-05,1785,2990,4346,2423,3419,2410,1181,18554,0
2017-04-06,1846,2773,4168,2455,4491,3582,1473,20788,0
2017-04-07,1630,2750,4530,2270,5044,2257,1303,19784,0
2017-04-08,0,1558,1935,0,966,240,372,5071,1
2017-04-09,0,1219,1236,0,993,156,157,3761,1
2017-04-10,1823,2482,4629,2335,4340,2136,1124,18869,0
2017-04-11,1674,2665,4921,2524,4626,2247,1216,19873,0
2017-04-12,1585,2511,4925,2519,4393,2652,1205,19790,0
2017-04-13,1738,3311,4568,2319,3888,2336,1292,19452,0
2017-04-14,1202,2454,3806,2050,3316,1616,1305,15749,0
2017-04-15,0,1520,2002,0,1442,355,363,5682,1
2017-04-16,0,1223,1199,0,959,154,164,3699,1
2017-04-17,1578,2190,4610,2461,4246,2061,1284,18430,0
2017-04-18,1596,2817,4774,2047,4620,2107,1250,19211,0
2017-04-19,1613,2854,4759,2423,4643,2070,1207,19569,0
2017-04-20,1539,2997,4819,2152,4278,2249,1127,19161,0
2017-04-21,1653,2957,4570,2386,4415,1851,1215,19047,0
2017-04-22,0,1752,2132,0,1187,272,414,5757,1
2017-04-23,0,1293,1454,0,873,251,229,4100,1
2017-04-24,1777,2651,4333,2435,3781,1951,1348,18276,0
2017-04-25,1757,2626,4370,2343,4572,1647,1287,18602,0
2017-04-26,1583,3150,3722,1886,4742,2174,1159,18416,0
2017-04-27,1814,2879,4850,2596,4545,2398,1357,20439,0
2017-04-28,1454,2704,4240,2224,4314,1920,827,17683,0
2017-04-29,0,1422,1889,0,1017,152,556,5036,1
2017-04-30,0,1016,1260,0,755,206,287,3524,1
2018-04-01,0,1066,1251,0,819,204,172,3512,1
2018-04-02,1627,3086,5039,2080,4353,2068,1197,19450,0
2018-04-03,1794,2978,5089,2289,4523,2232,1432,20337,0
2018-04-04,1611,2968,5146,1873,4201,2187,1489,19475,0
2018-04-05,1651,3146,5039,2285,3271,2092,1299,18783,0
2018-04-06,1288,3105,4553,1633,3823,1900,1313,17615,0
2018-04-07,0,1319,2066,0,1136,426,271,5218,1
2018-04-08,0,1115,1541,0,888,257,196,3997,1
2018-04-09,1674,3107,4620,2525,3831,2072,1573,19402,0
2018-04-10,1624,3400,5001,2459,4191,2245,1396,20316,0
2018-04-11,1836,3167,4917,2329,4180,2157,1378,19964,0
2018-04-12,1588,3049,4634,2510,4021,2123,1341,19266,0
2018-04-13,1532,3136,5162,2175,3504,2070,1338,18917,0
2018-04-14,0,1340,2159,0,1335,378,378,5590,1
2018-04-15,0,1222,1518,0,951,235,230,4156,1
2018-04-16,1718,3032,4750,2489,3728,1889,1334,18940,0
2018-04-17,1767,2919,5059,2495,5085,2200,1249,20774,0
2018-04-18,1536,2961,4782,2486,4123,2265,1483,19636,0
2018-04-19,1576,3090,5257,2443,4193,2187,1626,20372,0
2018-04-20,1397,2321,4651,2070,4407,1501,1461,17808,0
2018-04-21,0,1304,2209,0,752,275,282,4822,1
2018-04-22,0,1102,1769,0,795,174,234,4074,1
2018-04-23,1750,2894,4878,2437,4125,2216,1460,19760,0
2018-04-24,1666,2991,4984,2365,4206,2074,1346,19632,0
2018-04-25,1644,3032,4824,2470,3926,2054,1427,19377,0
2018-04-26,1604,3197,4921,2354,4030,2108,1315,19529,0
2018-04-27,1491,3011,4920,2244,4397,1932,1558,19553,0
2018-04-28,0,1661,1965,0,1334,380,410,5750,1
2018-04-29,0,1211,1321,0,1117,282,275,4206,1
2018-04-30,1740,2813,4912,2329,3689,2123,1394,19000,0
2019-04-01,1499,2735,4278,2091,3432,2424,1149,17608,0
2019-04-02,1576,3022,4811,2300,3926,2415,1287,19337,0
2019-04-03,1594,2920,4861,2363,3896,2468,1437,19539,0
2019-04-04,1622,3134,4876,2083,4369,2434,1343,19861,0
2019-04-05,1488,3130,4803,1908,4498,2260,1295,19382,0
2019-04-06,0,1084,1907,0,1600,312,463,5366,1
2019-04-07,0,899,1183,0,1128,321,279,3810,1
2019-04-08,1442,3100,5170,2473,4359,2539,1301,20384,0
2019-04-09,1540,3015,5277,2380,4317,2422,1274,20225,0
2019-04-10,1638,2993,5310,2403,4049,2242,1292,19927,0
2019-04-11,1569,3242,5438,2473,3839,2449,1038,20048,0
2019-04-12,1561,2972,5112,2181,3591,2305,1361,19083,0
2019-04-13,0,1248,2554,0,775,282,576,5435,1
2019-04-14,0,980,1743,0,718,186,379,4006,1
2019-04-15,1688,3052,5218,2152,4243,2404,1741,20498,0
2019-04-16,1639,2582,5403,2309,3910,2139,1284,19266,0
2019-04-17,1722,3163,5603,2276,3784,2188,1535,20271,0
2019-04-18,1630,3123,5532,2113,4201,2524,1309,20432,0
2019-04-19,1237,2776,4892,1674,3915,2121,1218,17833,0
2019-04-20,0,1451,1869,0,1096,334,300,5050,1
2019-04-21,0,855,1111,0,926,202,190,3284,1
2019-04-22,2348,4117,8475,2876,6326,3022,1760,28924,0
2019-04-23,1682,3214,5302,2121,3704,2447,1184,19654,0
2019-04-24,1582,3047,5539,2150,4194,2492,1247,20251,0
2019-04-25,1571,3007,5298,2358,4135,2658,1314,20341,0
2019-04-26,1282,2897,5457,2192,3534,2352,1411,19125,0
2019-04-27,0,1037,2426,0,1277,235,342,5317,1
2019-04-28,0,997,1489,0,977,238,238,3939,1
2019-04-29,1512,2817,5151,2151,3998,2390,1529,19548,0
2019-04-30,1671,3031,5177,2202,4144,2306,1237,19768,0
2021-04-01,204,669,1063,212,521,502,268,3439,0
2021-04-02,188,697,1061,173,484,380,261,3244,0
2021-04-03,0,596,737,0,385,157,175,2050,1
2021-04-04,0,431,354,0,256,99,82,1222,1
2021-04-05,221,771,1092,222,530,536,292,3664,0
2021-04-06,208,744,1018,231,540,497,319,3557,0
2021-04-07,224,692,1016,207,549,481,322,3491,0
2021-04-08,206,658,1002,198,533,454,300,3351,0
2021-04-09,188,723,1012,207,561,454,294,3439,0
2021-04-10,0,597,739,0,215,77,169,1797,1
2021-04-11,0,391,498,0,258,36,111,1294,1
2021-04-12,216,696,1082,217,528,486,310,3535,0
2021-04-13,221,717,1135,214,519,549,293,3648,0
2021-04-14,203,663,1022,231,528,522,287,3456,0
2021-04-15,206,706,1180,206,524,560,314,3696,0
2021-04-16,178,664,1021,210,529,427,266,3295,0
2021-04-17,0,560,776,0,377,169,145,2027,1
2021-04-18,0,469,516,0,363,160,113,1621,1
2021-04-19,178,648,1101,225,575,527,301,3555,0
2021-04-20,200,688,1012,227,561,532,294,3514,0
2021-04-21,198,671,978,217,569,606,280,3519,0
2021-04-22,216,667,1031,227,507,525,297,3470,0
2021-04-23,191,758,1153,199,499,458,261,3519,0
2021-04-24,0,451,714,0,384,195,142,1886,1
2021-04-25,0,317,409,0,230,156,79,1191,1
2021-04-26,219,653,1123,225,543,565,305,3633,0
2021-04-27,231,683,1047,232,500,559,334,3586,0
2021-04-28,234,701,1162,235,591,595,307,3825,0
2021-04-29,227,685,1169,225,551,548,310,3715,0
2021-04-30,176,779,1179,218,579,498,295,3724,0
2016-05-01,0,1359,1504,0,1157,315,218,4553,1
2016-05-02,1810,3141,5000,2221,4353,2084,1304,19913,0
2016-05-03,1757,3218,5208,2358,4382,2447,1205,20575,0
2016-05-04,1817,2997,5150,2351,4134,2412,1128,19989,0
2016-05-05,1779,3140,5683,2406,4479,2408,1534,21429,0
2016-05-06,1733,2695,5323,2075,4668,2436,1443,20373,0
2016-05-07,0,1360,1797,0,1258,172,275,4862,1
2016-05-08,0,1350,1410,0,1070,267,215,4312,1
2016-05-09,1282,3275,5429,2282,4276,2450,1274,20268,0
2016-05-10,1901,2934,5409,2081,4348,2102,1078,19853,0
2016-05-11,1875,3080,5426,2201,3250,2351,1400,19583,0
2016-05-12,1767,2675,5011,2306,4196,2072,1488,19515,0
2016-05-13,1600,2761,4964,1177,3669,1861,1148,17180,0
2016-05-14,0,1560,2345,0,1249,611,313,6078,1
2016-05-15,0,1114,1558,0,895,443,162,4172,1
2016-05-16,1854,3162,5438,2300,3322,2651,1368,20095,0
2016-05-17,1897,2822,5226,2290,3815,2601,1481,20132,0
2016-05-18,1899,3098,5280,2239,4546,2444,1314,20820,0
2016-05-19,1519,3123,5405,2306,4110,2152,1420,20035,0
2016-05-20,1578,2668,4893,1975,4077,2556,1240,18987,0
2016-05-21,0,1490,2103,0,1114,781,337,5825,1
2016-05-22,0,1090,1461,0,916,423,164,4054,1
2016-05-23,1776,3046,4959,2069,4277,1755,1345,19227,0
2016-05-24,1913,3040,4847,2555,4207,2136,1165,19863,0
2016-05-25,1623,3098,4799,2291,4457,2296,946,19510,0
2016-05-26,1828,3088,4580,2224,3963,1932,1059,18674,0
2016-05-27,1622,2964,4509,1908,4123,2323,1168,18617,0
2016-05-28,0,764,2283,0,1799,693,400,5939,1
2016-05-29,0,1019,1689,0,967,543,236,4454,1
2016-05-30,0,301,0,0,0,0,0,301,0
2016-05-31,1772,3080,5082,2211,3737,2526,1216,19624,0
2017-05-01,1629,2060,4607,2354,3457,1985,1184,17276,0
2017-05-02,1836,2280,4984,2364,4573,2293,1165,19495,0
2017-05-03,1917,3144,4879,2512,4236,2113,1163,19964,0
2017-05-04,1432,2675,4947,2425,4131,2344,1295,19249,0
2017-05-05,1530,3490,4896,2367,3771,1986,922,18962,0
2017-05-06,0,387,1413,0,1350,226,322,3698,1
2017-05-07,0,381,1086,0,966,111,204,2748,1
2017-05-08,2039,3154,5123,2411,3893,2187,1197,20004,0
2017-05-09,1905,3202,5095,2575,3951,2294,1214,20236,0
2017-05-10,2006,2721,5084,2487,4111,2367,1286,20062,0
2017-05-11,1972,3073,5119,2555,3901,2401,1239,20260,0
2017-05-12,1553,2984,4361,2295,4560,2156,1250,19159,0
2017-05-13,0,428,2047,0,1096,329,334,4234,1
2017-05-14,0,354,1537,0,1013,437,207,3548,1
2017-05-15,1854,2840,4533,2409,4543,2062,1159,19400,0
2017-05-16,1952,2987,5028,2556,4635,2270,1277,20705,0
2017-05-17,1888,2895,4513,2120,4312,2194,1178,19100,0
2017-05-18,1888,2833,5076,2540,4091,2184,1044,19656,0
2017-05-19,1644,2573,4651,1668,4139,2257,1064,17996,0
2017-05-20,0,429,1905,0,940,431,341,4046,1
2017-05-21,0,386,755,0,891,342,113,2487,1
2017-05-22,1873,3273,4808,2270,4005,2251,1420,19900,0
2017-05-23,1814,3100,4859,2381,4099,2261,1369,19883,0
2017-05-24,1906,2795,4655,2254,4202,2508,930,19250,0
2017-05-25,1722,2987,4831,2360,4061,2484,1286,19731,0
2017-05-26,1530,2730,3976,1976,3371,2087,1260,16930,0
2017-05-27,0,1305,1849,0,1176,449,309,5088,1
2017-05-28,0,1187,1250,0,1202,579,341,4559,1
2017-05-29,0,972,939,0,705,229,123,2968,0
2017-05-30,1742,3125,4954,2379,4140,2463,1471,20274,0
2017-05-31,1774,3072,4848,2388,4376,2466,1119,20043,0
2018-05-01,1657,2948,4605,2469,4405,2062,1306,19452,0
2018-05-02,1782,3150,4624,2297,4439,2173,1534,19999,0
2018-05-03,1653,3162,4608,2358,4618,2251,1320,19970,0
2018-05-04,1397,3307,4509,1737,3639,1968,1602,18159,0
2018-05-05,0,1607,2430,0,1376,432,339,6184,1
2018-05-06,0,1126,1502,0,1113,323,266,4330,1
2018-05-07,1765,3051,4803,2509,3938,2331,1099,19496,0
2018-05-08,1732,2998,5086,2440,4344,2319,1365,20284,0
2018-05-09,1758,3136,5232,2524,4042,2150,1639,20481,0
2018-05-10,1641,2957,4775,2142,4221,2170,1362,19268,0
2018-05-11,1366,3415,4772,1976,4689,1927,1613,19758,0
2018-05-12,0,1479,3105,0,1080,294,442,6400,1
2018-05-13,0,1184,1476,0,1207,208,284,4359,1
2018-05-14,1803,3110,4665,2770,4042,2161,1451,20002,0
2018-05-15,1644,2997,4840,2565,4799,1973,1491,20309,0
2018-05-16,1770,2975,4807,2387,4380,2279,1573,20171,0
2018-05-17,1632,2926,4935,2473,4094,2235,1340,19635,0
2018-05-18,1472,3478,4395,2024,4446,1953,1525,19293,0
2018-05-19,0,1339,1914,0,1052,195,336,4836,1
2018-05-20,0,1131,1270,0,835,144,208,3588,1
2018-05-21,1672,3057,4287,2160,3665,2052,1555,18448,0
2018-05-22,1684,2799,4808,2389,4371,2305,1447,19803,0
2018-05-23,1461,2913,4408,2399,3435,2188,1686,18490,0
2018-05-24,1470,3122,4585,2236,3905,2098,1310,18726,0
2018-05-25,1218,3160,3542,2206,3416,1975,1432,16949,0
2018-05-26,0,2082,2097,0,1451,387,402,6419,1
2018-05-27,0,1517,1718,0,1087,243,285,4850,1
2018-05-28,0,1398,1120,0,687,124,132,3461,0
2018-05-29,1554,2588,4442,2446,3771,2197,1241,18239,0
2018-05-30,1508,2919,4488,2388,4235,2170,1440,19148,0
2018-05-31,1658,2991,4463,2359,4098,2181,1294,19044,0
2019-05-01,1679,2876,5278,2256,4166,2316,1349,19920,0
2019-05-02,1530,3159,5126,2268,3592,2311,1730,19716,0
2019-05-03,1278,3108,5068,2114,3661,1755,1371,18355,0
2019-05-04,0,1256,2060,0,1188,292,366,5162,1
2019-05-05,0,1043,1694,0,1297,337,326,4697,1
2019-05-06,1845,2879,5267,2153,4131,2177,1250,19702,0
2019-05-07,1705,2796,4960,2365,3744,2277,1697,19544,0
2019-05-08,1685,2950,5122,2404,4055,2278,1522,20016,0
2019-05-09,1716,2855,5344,2361,3947,2446,1074,19743,0
2019-05-10,1527,2788,5215,2391,3800,2379,1449,19549,0
2019-05-11,0,1184,1631,0,1093,271,400,4579,1
2019-05-12,0,924,1361,0,1174,227,367,4053,1
2019-05-13,1776,3120,4785,2290,4422,2262,1294,19949,0
2019-05-14,1823,3090,5040,2485,4080,2280,1502,20300,0
2019-05-15,1661,2866,5041,2255,3746,2199,1280,19048,0
2019-05-16,1514,2802,4980,2468,4074,2319,1558,19715,0
2019-05-17,1264,2968,4887,2196,4572,2147,1087,19121,0
2019-05-18,0,1208,2014,0,1230,468,420,5340,1
2019-05-19,0,813,1107,0,948,155,170,3193,1
2019-05-20,1715,3033,4840,2155,4357,2340,1466,19906,0
2019-05-21,1739,2822,4838,2586,4584,2236,1382,20187,0
2019-05-22,1593,2961,4685,2291,3998,2278,1345,19151,0
2019-05-23,1599,2700,4702,2404,4792,2162,1194,19553,0
2019-05-24,1504,2745,4825,2126,4073,1769,1139,18181,0
2019-05-25,0,1546,1665,0,1377,247,445,5280,1
2019-05-26,0,780,1055,0,1228,133,186,3382,1
2019-05-27,0,903,1171,0,1298,187,152,3711,0
2019-05-28,1646,2979,5115,2222,4012,2292,970,19236,0
2019-05-29,1731,3126,5252,2466,4161,2295,1235,20266,0
2019-05-30,1727,2892,5378,2116,3895,2279,1127,19414,0
2019-05-31,1508,2883,4957,1937,3832,2161,1158,18436,0
2021-05-01,0,523,752,0,389,223,159,2046,1
2021-05-02,0,469,459,0,364,268,94,1654,1
2021-05-03,230,706,954,297,534,514,301,3536,0
2021-05-04,227,779,1259,242,598,626,304,4035,0
2021-05-05,219,776,1102,291,617,582,374,3961,0
2021-05-06,198,648,1150,260,624,538,305,3723,0
2021-05-07,194,765,1098,214,582,495,345,3693,0
2021-05-08,0,527,410,0,418,308,138,1801,1
2021-05-09,0,442,548,0,392,186,96,1664,1
2021-05-10,228,770,1167,254,588,579,321,3907,0
2021-05-11,245,808,1122,312,607,616,295,4005,0
2021-05-12,272,724,1124,262,613,563,341,3899,0
2021-05-13,228,790,1184,291,634,545,317,3989,0
2021-05-14,213,775,1206,259,574,474,306,3807,0
2021-05-15,0,594,736,0,495,258,120,2203,1
2021-05-16,0,470,526,0,382,184,112,1674,1
2021-05-17,196,752,1207,281,549,565,339,3889,0
2021-05-18,260,823,1235,289,729,606,400,4342,0
2021-05-19,256,733,1282,295,629,557,374,4126,0
2021-05-20,259,754,1225,294,687,556,356,4131,0
2021-05-21,234,772,1107,220,594,466,342,3735,0
2021-05-22,0,669,802,0,593,226,135,2425,1
2021-05-23,0,491,576,0,371,192,120,1750,1
2021-05-24,254,772,1242,270,678,586,376,4178,0
2021-05-25,264,807,1254,282,680,588,333,4208,0
2021-05-26,290,745,1261,292,735,604,373,4300,0
2021-05-27,241,733,1122,241,657,627,359,3980,0
2021-05-28,222,821,1227,237,610,487,291,3895,0
2021-05-29,130,715,736,0,544,344,221,2690,1
2021-05-30,0,453,587,0,641,247,127,2055,1
2021-05-31,0,502,613,0,360,238,105,1818,0
2016-06-01,1706,3010,4788,2376,3837,2274,1070,19061,0
2016-06-02,1751,3273,5169,2393,3709,1885,1127,19307,0
2016-06-03,1416,2943,5188,2057,3562,2041,1134,18341,0
2016-06-04,0,1412,2204,0,1110,768,315,5809,1
2016-06-05,0,1125,1435,0,892,482,149,4083,1
2016-06-06,1744,2863,4760,2323,4073,2137,1087,18987,0
2016-06-07,1416,3020,4661,2364,3714,2341,1235,18751,0
2016-06-08,1704,3161,4470,2301,3694,1813,1260,18403,0
2016-06-09,1672,3030,4633,2318,4180,2141,1172,19146,0
2016-06-10,1501,3162,4240,2138,4271,2402,1120,18834,0
2016-06-11,0,1525,2262,0,1052,414,389,5642,1
2016-06-12,0,1150,1291,0,392,156,223,3212,1
2016-06-13,1714,2651,4586,2334,3666,2098,1280,18329,0
2016-06-14,1642,2990,3982,2273,4153,2155,1251,18446,0
2016-06-15,1733,2846,4569,2313,4504,2203,1247,19415,0
2016-06-16,1820,2898,17535,2184,3979,2139,1310,31865,0
2016-06-17,1178,3209,4725,1887,3674,2268,1401,18342,0
2016-06-18,0,1742,2039,0,1359,600,250,5990,1
2016-06-19,0,951,1043,0,592,488,198,3272,1
2016-06-20,1782,2955,4928,2189,3700,1652,1199,18405,0
2016-06-21,1639,2935,4957,2377,4250,2073,1295,19526,0
2016-06-22,1865,3040,4725,2313,3645,2188,1302,19078,0
2016-06-23,1660,3080,4968,2348,4103,2224,1269,19652,0
2016-06-24,1423,2875,4621,2124,4532,2212,1099,18886,0
2016-06-25,0,1366,1864,0,1333,690,240,5493,1
2016-06-26,0,832,1173,0,925,580,163,3673,1
2016-06-27,1562,2852,4739,2394,4201,1845,1174,18767,0
2016-06-28,1648,3154,4600,2325,5135,1861,1294,20017,0
2016-06-29,1674,2684,4649,2327,4199,2149,1311,18993,0
2016-06-30,1589,2647,4986,2224,4022,1684,1226,18378,0
2017-06-01,1754,3104,4476,2400,4061,2347,1235,19377,0
2017-06-02,1609,3119,4411,2163,4478,2342,1196,19318,0
2017-06-03,0,1422,1533,0,1125,450,284,4814,1
2017-06-04,0,1157,1312,0,974,513,226,4182,1
2017-06-05,1737,3128,4678,2300,4352,2394,846,19435,0
2017-06-06,1839,3037,4706,2462,3992,2541,1150,19727,0
2017-06-07,1679,3129,4830,2451,3724,2480,1218,19511,0
2017-06-08,1775,3195,4805,2519,3860,2523,1249,19926,0
2017-06-09,1578,3137,4994,2215,3585,2330,1236,19075,0
2017-06-10,0,1506,2109,0,1403,498,281,5797,1
2017-06-11,0,1188,1338,0,1015,295,168,4004,1
2017-06-12,1811,2930,4683,2259,4385,2380,1160,19608,0
2017-06-13,2100,1599,4476,2220,4341,3637,1992,20365,0
2017-06-14,1770,3032,4625,2331,4507,2488,1108,19861,0
2017-06-15,1839,3087,4873,2194,4144,2296,1152,19585,0
2017-06-16,1628,2959,4255,2095,4092,1968,1048,18045,0
2017-06-17,0,1490,2325,0,1239,659,380,6093,1
2017-06-18,0,1141,1281,0,1270,461,190,4343,1
2017-06-19,1883,3015,4505,2309,3799,2403,1183,19097,0
2017-06-20,2470,2726,4559,2472,4095,1994,1190,19506,0
2017-06-21,1852,3064,4549,2338,4010,2690,1056,19559,0
2017-06-22,1806,3230,4325,2399,3821,3007,1265,19853,0
2017-06-23,1628,2863,4549,2198,3539,2071,1127,17975,0
2017-06-24,0,1447,2111,0,1299,1032,325,6214,1
2017-06-25,0,995,1063,0,1228,654,242,4182,1
2017-06-26,1859,2520,4200,1673,4002,2093,1071,17418,0
2017-06-27,1907,2945,4922,2395,4046,2354,1242,19811,0
2017-06-28,1766,3111,4622,2439,4153,2441,1210,19742,0
2017-06-29,1767,3205,4473,2365,4191,2535,1296,19832,0
2017-06-30,1602,3310,4498,2121,4133,2271,1232,19167,0
2018-06-01,1311,3082,4228,1953,4330,1942,1330,18176,0
2018-06-02,0,1377,2117,0,1345,230,372,5441,1
2018-06-03,0,1137,1232,0,799,292,217,3677,1
2018-06-04,1571,3133,4567,2389,4303,2119,1090,19172,0
2018-06-05,1510,3138,4247,2509,4258,2118,1218,18998,0
2018-06-06,1499,3152,4689,2371,4112,2144,1535,19502,0
2018-06-07,1548,3182,4711,2379,4039,2075,1308,19242,0
2018-06-08,1386,3249,4497,1966,3546,2007,1516,18167,0
2018-06-09,0,1509,1745,0,1033,533,494,5314,1
2018-06-10,0,1019,1561,0,1086,559,276,4501,1
2018-06-11,1594,2958,4238,2572,4277,2091,1560,19290,0
2018-06-12,1555,3131,4921,2545,3901,2202,1291,19546,0
2018-06-13,1656,3008,4873,1592,3834,2011,1589,18563,0
2018-06-14,1486,3134,4645,2525,3603,2217,1216,18826,0
2018-06-15,1289,2975,4543,2207,3393,2113,1284,17804,0
2018-06-16,0,1440,2067,0,1035,502,421,5465,1
2018-06-17,0,979,1744,0,884,259,228,4094,1
2018-06-18,1576,3101,4103,2366,4170,2147,1528,18991,0
2018-06-19,1581,3203,4609,1777,4030,2206,1318,18724,0
2018-06-20,1588,2889,4536,2337,4001,2290,1541,19182,0
2018-06-21,1430,2934,4778,2485,4387,2242,1322,19578,0
2018-06-22,1412,3112,4444,2021,3708,2063,1265,18025,0
2018-06-23,0,1413,1888,0,1379,563,385,5628,1
2018-06-24,0,1213,1448,0,1077,439,298,4475,1
2018-06-25,1498,3044,4232,2402,4102,2093,1515,18886,0
2018-06-26,1661,3116,4822,2521,4234,2005,1359,19718,0
2018-06-27,1631,3017,4794,4178,4222,2074,1339,21255,0
2018-06-28,1647,3006,5362,70,4182,2178,1927,18372,0
2018-06-29,1359,3421,4314,1952,3810,1764,1625,18245,0
2018-06-30,0,1382,2205,0,1383,640,598,6208,1
2019-06-01,0,1218,1735,0,1191,234,210,4588,1
2019-06-02,0,1024,1942,0,1051,199,277,4493,1
2019-06-03,1576,3095,4347,2164,3979,2165,1312,18638,0
2019-06-04,1622,3072,5097,2182,4001,2146,1212,19332,0
2019-06-05,1720,3074,4773,2258,4095,2210,1253,19383,0
2019-06-06,1548,3152,4797,2334,4246,2196,1247,19520,0
2019-06-07,1478,2865,4794,1964,3977,2102,1257,18437,0
2019-06-08,0,1383,2335,0,1452,295,313,5778,1
2019-06-09,0,1079,1683,0,1284,301,235,4582,1
2019-06-10,1658,2895,4754,2177,4387,2290,1345,19506,0
2019-06-11,1614,3149,5106,2357,4042,2220,1259,19747,0
2019-06-12,1484,3114,4963,2362,4108,2290,1095,19416,0
2019-06-13,1567,3110,4890,2277,3588,2438,1161,19031,0
2019-06-14,1342,3087,4990,1708,3434,2114,1306,17981,0
2019-06-15,0,1566,1883,0,1321,477,314,5561,1
2019-06-16,0,1140,1483,0,1200,412,250,4485,1
2019-06-17,1459,2979,4900,2177,3989,2058,1157,18719,0
2019-06-18,1560,3257,4762,2186,3665,2192,1267,18889,0
2019-06-19,1723,2994,5243,2411,3959,2283,1239,19852,0
2019-06-20,1739,3159,4801,2445,4190,2288,1200,19822,0
2019-06-21,1395,2657,4465,2147,3288,1990,1063,17005,0
2019-06-22,0,1176,2369,0,1285,508,296,5634,1
2019-06-23,0,988,1597,0,1071,569,170,4395,1
2019-06-24,1485,3167,4524,2260,3818,2200,1289,18743,0
2019-06-25,1739,3126,4889,2536,4841,2149,1096,20376,0
2019-06-26,1711,3048,4834,2551,3660,2041,923,18768,0
2019-06-27,1537,3039,4788,2543,4130,2293,981,19311,0
2019-06-28,1349,2841,4717,2333,4247,2135,1361,18983,0
2019-06-29,0,1369,1793,0,1460,777,351,5750,1
2019-06-30,0,1113,1379,0,1373,667,418,4950,1
2021-06-01,282,873,1269,284,690,581,344,4323,0
2021-06-02,304,750,1111,290,710,586,381,4132,0
2021-06-03,255,787,930,345,692,563,366,3938,0
2021-06-04,241,855,1217,264,600,538,359,4074,0
2021-06-05,20,644,658,0,588,295,184,2389,1
2021-06-06,0,501,472,0,504,305,91,1873,1
2021-06-07,276,816,1260,300,754,581,339,4326,0
2021-06-08,270,808,1305,292,794,634,414,4517,0
2021-06-09,266,671,1341,288,741,571,370,4248,0
2021-06-10,268,860,1266,323,690,589,359,4355,0
2021-06-11,239,891,1313,255,710,545,349,4302,0
2021-06-12,26,605,500,0,608,342,176,2257,1
2021-06-13,0,580,400,0,505,312,162,1959,1
2021-06-14,271,891,1264,272,735,566,420,4419,0
2021-06-15,312,910,1323,266,692,630,421,4554,0
2021-06-16,275,858,1401,317,782,606,384,4623,0
2021-06-17,254,769,1392,352,786,639,375,4567,0
2021-06-18,223,716,1318,250,724,524,334,4089,0
2021-06-19,15,603,780,0,657,475,181,2711,1
2021-06-20,0,489,495,0,539,356,92,1971,1
2021-06-21,313,873,1245,291,737,611,396,4466,0
2021-06-22,306,1037,1355,321,835,656,440,4950,0
2021-06-23,329,882,1355,362,859,577,417,4781,0
2021-06-24,318,812,1452,362,816,621,404,4785,0
2021-06-25,290,773,1343,269,819,586,360,4440,0
2021-06-26,38,636,979,0,661,393,198,2905,1
2021-06-27,0,430,620,0,570,456,132,2208,1
2021-06-28,275,782,1377,330,736,634,392,4526,0
2021-06-29,328,912,1338,360,861,630,482,4911,0
2021-06-30,315,860,1330,342,797,549,438,4631,0
2015-07-01,2025,3165,5435,2278,4313,2249,1181,20646,0
2015-07-02,1650,3209,5094,1815,3906,1928,1093,18695,0
2015-07-03,0,1065,0,0,0,0,0,1065,0
2015-07-04,0,1248,1817,0,1029,771,236,5101,1
2015-07-05,0,1452,1497,0,1341,633,198,5121,1
2015-07-06,1818,3074,5519,2271,4337,2222,1238,20479,0
2015-07-07,1762,3098,5385,2232,4317,2345,1208,20347,0
2015-07-08,1736,2971,5712,2368,4482,2299,1222,20790,0
2015-07-09,1860,3051,5375,2244,4393,2438,1165,20526,0
2015-07-10,1942,3033,5261,1957,3940,2201,1145,19479,0
2015-07-11,0,1577,2432,0,1372,1382,232,6995,1
2015-07-12,0,1268,1620,0,1236,943,171,5238,1
2015-07-13,1927,2781,5281,2277,4018,2272,1102,19658,0
2015-07-14,1771,3058,5459,2327,4342,2335,1315,20607,0
2015-07-15,1992,3056,5386,2351,4267,2303,1239,20594,0
2015-07-16,1989,2825,5656,2306,4571,2368,1194,20909,0
2015-07-17,2013,2848,4766,1890,4682,2554,993,19746,0
2015-07-18,0,1437,2003,0,1330,749,139,5658,1
2015-07-19,0,1283,1323,0,1352,664,81,4703,1
2015-07-20,1918,2888,5450,1172,4770,2224,1089,19511,0
2015-07-21,2010,3017,5662,2236,4809,2234,1201,21169,0
2015-07-22,2091,2811,5334,2247,4925,2263,1367,21038,0
2015-07-23,1990,2802,5387,1972,4422,2179,959,19711,0
2015-07-24,1717,2742,5324,1775,5027,1967,947,19499,0
2015-07-25,0,1334,1963,0,1588,1983,374,7242,1
2015-07-26,0,1362,1286,0,1331,1111,242,5332,1
2015-07-27,1931,2750,5224,2181,4045,2164,951,19246,0
2015-07-28,2003,2792,5170,2303,4411,2058,1082,19819,0
2015-07-29,1832,2788,5368,2401,4382,2105,1033,19909,0
2015-07-30,1971,2704,5191,2315,4138,2265,1321,19905,0
2015-07-31,1874,3006,5335,1974,4096,1885,1021,19191,0
2016-07-01,1371,3326,4567,2005,4033,1985,1236,18523,0
2016-07-02,0,1860,2524,0,1610,690,322,7006,1
2016-07-03,0,1389,1619,0,1234,670,213,5125,1
2016-07-04,0,349,0,0,0,0,0,349,0
2016-07-05,1342,2672,4517,2223,3985,2119,994,17852,0
2016-07-06,1563,3086,4715,2270,2966,2131,890,17621,0
2016-07-07,1316,2822,4707,2110,3783,2222,1133,18093,0
2016-07-08,1453,2875,4269,1814,3787,2117,1240,17555,0
2016-07-09,0,1474,2170,0,1552,687,269,6152,1
2016-07-10,0,915,1325,0,1041,420,214,3915,1
2016-07-11,1746,2763,4613,2260,4305,2173,1176,19036,0
2016-07-12,1543,2747,4539,2338,4112,2188,1274,18741,0
2016-07-13,1675,2856,4748,2246,4031,2057,1241,18854,0
2016-07-14,1483,3032,4857,1955,4224,2168,1209,18928,0
2016-07-15,1483,2737,4892,1889,4375,2430,1214,19020,0
2016-07-16,0,1645,2006,0,962,1115,293,6021,1
2016-07-17,0,1070,1496,0,1012,655,275,4508,1
2016-07-18,1808,2963,4448,2382,4647,2062,758,19068,0
2016-07-19,1699,2895,4420,2334,4711,2157,1410,19626,0
2016-07-20,1443,3099,4145,2242,4111,2016,1225,18281,0
2016-07-21,1614,2697,4259,2085,3541,2214,1312,17722,0
2016-07-22,1176,2335,4576,2147,3970,2139,1228,17571,0
2016-07-23,0,924,1941,0,1695,1576,266,6402,1
2016-07-24,0,731,1446,0,1256,685,171,4289,1
2016-07-25,1508,1397,5168,2166,3940,2157,1373,17709,0
2016-07-26,1731,1209,4743,2043,4399,2359,1272,17756,0
2016-07-27,1769,1978,4905,2103,4464,2162,1321,18702,0
2016-07-28,1673,2426,4767,2084,4313,2285,1181,18729,0
2016-07-29,1517,2532,4514,1932,3860,2353,1254,17962,0
2016-07-30,0,888,2222,0,1427,1005,340,5882,1
2016-07-31,0,1065,1327,0,1105,928,209,4634,1
2017-07-01,0,1488,2027,0,1146,950,313,5924,1
2017-07-02,0,1249,1565,0,1370,514,415,5113,1
2017-07-03,891,2441,3354,1378,2783,1422,588,12857,0
2017-07-04,0,818,986,0,493,134,85,2516,0
2017-07-05,1769,3063,4208,2219,3658,1877,1140,17934,0
2017-07-06,1929,3086,4859,2329,3735,2093,1206,19237,0
2017-07-07,1362,3094,4458,2113,3572,2130,1095,17824,0
2017-07-08,0,1444,1530,0,1223,909,279,5385,1
2017-07-09,0,1015,1190,0,1167,766,260,4398,1
2017-07-10,1703,2890,4613,2266,4254,1701,1192,18619,0
2017-07-11,1852,3091,4299,2397,3868,2578,1206,19291,0
2017-07-12,1799,3055,4513,2351,3915,2203,1165,19001,0
2017-07-13,1767,3025,4825,2351,4229,2377,1201,19775,0
2017-07-14,1620,2491,4548,2074,4046,2300,1270,18349,0
2017-07-15,0,278,2335,0,1164,1180,346,5303,1
2017-07-16,0,950,1286,0,1437,886,158,4717,1
2017-07-17,1696,2466,4761,2364,4023,2418,1416,19144,0
2017-07-18,1689,3146,4875,2372,4817,2451,1407,20757,0
2017-07-19,1793,3030,4791,2522,4148,2454,1428,20166,0
2017-07-20,1587,2872,4395,2373,3315,2217,1303,18062,0
2017-07-21,1451,3259,4596,2011,4419,2125,1338,19199,0
2017-07-22,0,1509,2343,0,1915,0,154,5921,1
2017-07-23,0,1080,1382,0,1365,759,231,4817,1
2017-07-24,1800,3045,4731,2493,3958,2222,1187,19436,0
2017-07-25,1656,3149,4936,2134,4071,2318,1118,19382,0
2017-07-26,1801,3116,5342,2269,3791,2345,1357,20021,0
2017-07-27,1807,2977,5006,2283,3930,2149,1003,19155,0
2017-07-28,1596,2936,4414,2042,3927,1403,1103,17421,0
2017-07-29,0,1450,2143,0,762,1385,363,6103,1
2017-07-30,0,1217,1336,0,817,645,201,4216,1
2017-07-31,1750,2612,4810,2210,4006,2418,1277,19083,0
2018-07-01,0,1223,1417,0,1101,509,263,4513,1
2018-07-02,1454,3068,4428,2093,3685,1939,1314,17981,0
2018-07-03,1286,3216,4817,2120,3390,1960,1106,17895,0
2018-07-04,0,830,1012,0,774,293,148,3057,0
2018-07-05,1322,2126,4330,1795,3486,1774,998,15831,0
2018-07-06,1102,2819,4466,1959,4182,1027,1137,16692,0
2018-07-07,0,1318,1731,0,1285,896,329,5559,1
2018-07-08,0,1208,1267,0,1121,681,235,4512,1
2018-07-09,1620,2908,4037,2379,3484,1985,1430,17843,0
2018-07-10,1576,3099,4874,2490,4621,2102,1268,20030,0
2018-07-11,1668,3013,4625,2475,4252,6195,1593,23821,0
2018-07-12,1510,3277,4855,2514,4391,2171,1275,19993,0
2018-07-13,1297,2943,4552,1904,3365,2048,1348,17457,0
2018-07-14,0,1553,2379,0,1661,920,339,6852,1
2018-07-15,0,1191,1426,0,977,548,313,4455,1
2018-07-16,1523,2855,4009,2384,4289,2195,1409,18664,0
2018-07-17,1579,3062,4727,2422,4212,2310,1410,19722,0
2018-07-18,1717,2945,4604,2508,4418,2424,1481,20097,0
2018-07-19,1805,2945,4551,2409,4341,2046,1453,19550,0
2018-07-20,1394,2714,4373,2040,4557,1863,1513,18454,0
2018-07-21,0,1369,1978,0,1313,907,314,5881,1
2018-07-22,0,1079,1375,0,1265,739,213,4671,1
2018-07-23,1583,3044,4602,2063,4430,1996,1482,19200,0
2018-07-24,1591,2975,5027,2502,4533,2098,1245,19971,0
2018-07-25,1588,2993,4891,2348,4206,2042,1357,19425,0
2018-07-26,1586,2858,4860,2300,3972,2036,1137,18749,0
2018-07-27,1308,2841,4612,2101,4844,1858,1304,18868,0
2018-07-28,0,1420,2104,0,1491,874,317,6206,1
2018-07-29,0,1013,1445,0,1227,711,204,4600,1
2018-07-30,1481,2556,4762,1860,4020,2099,1232,18010,0
2018-07-31,1573,2830,4688,2385,3777,2113,1169,18535,0
2019-07-01,1645,3116,4412,2385,4009,2186,1138,18891,0
2019-07-02,1624,2909,4516,2379,3601,2149,1033,18211,0
2019-07-03,1388,3018,4818,2346,3705,2056,1378,18709,0
2019-07-04,0,859,1229,0,857,185,227,3357,0
2019-07-05,682,2097,3320,1099,2273,1254,578,11303,0
2019-07-06,0,1205,1573,0,1534,563,381,5256,1
2019-07-07,0,1209,1467,0,1121,444,209,4450,1
2019-07-08,1577,2804,4767,2371,3899,1769,1392,18579,0
2019-07-09,1511,2687,4996,2620,3836,2235,1320,19205,0
2019-07-10,1589,2971,5364,2578,4047,2309,1421,20279,0
2019-07-11,1628,2943,4955,2509,4165,2375,1333,19908,0
2019-07-12,1270,2899,4778,2272,4422,1685,1108,18434,0
2019-07-13,0,1370,2046,0,1535,921,329,6201,1
2019-07-14,0,1127,1310,0,847,555,176,4015,1
2019-07-15,1551,2708,4707,2213,4109,2411,1143,18842,0
2019-07-16,1579,2952,5089,2248,4488,2406,759,19521,0
2019-07-17,1545,2997,4954,2384,4374,2371,1476,20101,0
2019-07-18,1475,2732,4941,2338,3977,2151,1331,18945,0
2019-07-19,1343,2976,4827,1731,3833,2054,1243,18007,0
2019-07-20,0,1275,1394,0,1490,1061,296,5516,1
2019-07-21,0,1101,1302,0,1285,716,172,4576,1
2019-07-22,1544,2989,4462,2212,4146,2318,1276,18947,0
2019-07-23,1560,2846,5091,2285,3898,2307,1456,19443,0
2019-07-24,1720,2882,4928,2367,3708,2378,1220,19203,0
2019-07-25,1693,2883,5047,2236,3960,2264,1302,19385,0
2019-07-26,1316,2954,4636,1853,3827,2105,1302,17993,0
2019-07-27,0,1030,1667,0,1339,1186,277,5499,1
2019-07-28,0,1086,1192,0,1229,849,221,4577,1
2019-07-29,1609,3016,4792,2205,4108,2165,1382,19277,0
2019-07-30,1565,2964,4520,2508,4394,2265,1339,19555,0
2019-07-31,1565,2764,4916,2182,4071,2251,1311,19060,0
2015-08-01,0,1687,2454,0,1527,1498,367,7533,1
2015-08-02,0,1442,1927,0,1194,947,231,5741,1
2015-08-03,1857,3000,5233,2189,4432,2159,1004,19874,0
2015-08-04,1903,3040,5437,2208,4438,2275,1173,20474,0
2015-08-05,2014,2926,5593,2308,4196,2259,1247,20543,0
2015-08-06,1902,3097,5392,2383,4109,2245,1346,20474,0
2015-08-07,1775,3026,4858,1962,4873,2320,1048,19862,0
2015-08-08,0,1616,2092,0,1676,1275,343,7002,1
2015-08-09,0,1311,1402,0,1311,943,203,5170,1
2015-08-10,1964,2893,5399,2330,4198,2368,1043,20195,0
2015-08-11,1990,2413,5418,2313,4310,2031,1273,19748,0
2015-08-12,1915,2918,5541,2268,5112,2336,1097,21187,0
2015-08-13,1809,2953,5453,2397,4611,2130,1142,20495,0
2015-08-14,1813,3172,5069,1999,4173,2068,1262,19556,0
2015-08-15,0,1795,2201,0,1565,1253,242,7056,1
2015-08-16,0,1100,1437,0,1199,835,106,4677,1
2015-08-17,2044,2486,5564,2075,4801,2264,1117,20351,0
2015-08-18,2067,2917,5466,2397,5056,2447,1034,21384,0
2015-08-19,1969,2917,5472,2285,4182,2136,1209,20170,0
2015-08-20,1954,3134,5222,2221,4283,2302,1066,20182,0
2015-08-21,1741,3136,5188,2008,4896,2255,1307,20531,0
2015-08-22,0,1619,1880,0,1458,1219,288,6464,1
2015-08-23,0,1241,1309,0,1050,772,230,4602,1
2015-08-24,2182,3249,5490,2328,3692,2214,1217,20372,0
2015-08-25,2034,3024,5604,2401,4653,2106,885,20707,0
2015-08-26,1865,3017,5433,2383,3938,2256,1246,20138,0
2015-08-27,1663,3106,5455,2286,4410,2251,1080,20251,0
2015-08-28,1865,3231,5149,1795,4222,1885,1028,19175,0
2015-08-29,0,1385,1965,0,1376,1008,295,6029,1
2015-08-30,0,1214,1576,0,1305,710,157,4962,1
2015-08-31,2109,2919,5153,2111,4140,2239,1117,19788,0
2016-08-01,1559,2909,4420,2208,3961,2283,1353,18693,0
2016-08-02,1756,2981,4940,2163,4203,2306,1208,19557,0
2016-08-03,1592,3048,4707,2195,3980,2143,1566,19231,0
2016-08-04,1520,2819,4905,2297,4356,2282,1094,19273,0
2016-08-05,1289,3028,4549,1973,3105,2189,1307,17440,0
2016-08-06,0,1410,2033,0,1592,1010,273,6318,1
2016-08-07,0,1127,1312,0,1128,655,206,4428,1
2016-08-08,1662,2593,4531,2158,3814,2118,1520,18396,0
2016-08-09,1625,2754,4729,2166,4246,2102,1222,18844,0
2016-08-10,1720,3041,4890,2295,4362,2058,1395,19761,0
2016-08-11,1638,2762,4590,2292,4567,2084,1283,19216,0
2016-08-12,1322,2993,4507,1950,3090,2152,1223,17237,0
2016-08-13,0,1274,2220,0,1533,1060,267,6354,1
2016-08-14,0,1042,1616,0,1130,880,326,4994,1
2016-08-15,1667,2899,4481,1654,3991,2027,1483,18202,0
2016-08-16,1792,2428,4472,2071,4184,2059,1256,18262,0
2016-08-17,1602,2941,4428,2223,4437,2204,1417,19252,0
2016-08-18,1778,2827,3961,2112,4501,2315,1186,18680,0
2016-08-19,1617,2733,4435,1982,3854,2331,1157,18109,0
2016-08-20,0,1463,2304,0,1369,880,218,6234,1
2016-08-21,0,1131,1291,0,1222,705,171,4520,1
2016-08-22,1823,2683,5064,2237,4332,2234,1232,19605,0
2016-08-23,1742,2794,5361,2316,3855,2526,1646,20240,0
2016-08-24,1883,3055,5038,2394,4434,2371,1286,20461,0
2016-08-25,1752,3040,4813,2348,5014,2325,1267,20559,0
2016-08-26,1753,3167,4769,1685,3605,2300,1207,18486,0
2016-08-27,0,1296,2068,0,1601,692,203,5860,1
2016-08-28,0,1104,1382,0,1020,631,234,4371,1
2016-08-29,1676,3148,4834,2193,4204,2041,1254,19350,0
2016-08-30,1807,3022,4301,2163,4344,2248,1266,19151,0
2016-08-31,1508,2997,4567,2248,3116,2238,1034,17708,0
2017-08-01,1813,3019,5105,2282,4659,1658,1206,19742,0
2017-08-02,1781,2743,5265,2338,4327,2375,1369,20198,0
2017-08-03,1584,3059,4911,2306,4061,2390,1295,19606,0
2017-08-04,1721,1428,4655,1629,4209,2211,1481,17334,0
2017-08-05,0,1531,2289,0,1449,1179,370,6818,1
2017-08-06,0,1171,1402,0,1226,878,211,4888,1
2017-08-07,1731,3023,4761,2280,4294,2334,1254,19677,0
2017-08-08,2004,2736,5065,2344,4732,2489,1189,20559,0
2017-08-09,1940,2837,4586,2080,4009,2424,1392,19268,0
2017-08-10,1811,2997,5137,2249,4012,2349,1306,19861,0
2017-08-11,1579,3013,4750,1950,3542,2174,1455,18463,0
2017-08-12,0,1451,1977,0,1222,1093,291,6034,1
2017-08-13,0,1169,1267,0,1221,840,312,4809,1
2017-08-14,1694,3057,5089,2086,4086,2342,1379,19733,0
2017-08-15,1707,3008,4999,2258,2688,2475,2080,19215,0
2017-08-16,1831,3029,4860,2173,3744,2460,1267,19364,0
2017-08-17,1814,3024,4922,2340,4119,2401,819,19439,0
2017-08-18,1620,2995,4315,2025,3867,2022,1339,18183,0
2017-08-19,0,1386,2104,0,1213,917,348,5968,1
2017-08-20,0,1152,1246,0,895,530,211,4034,1
2017-08-21,1742,3102,5104,2335,4428,2591,1299,20601,0
2017-08-22,1836,3269,5282,2436,4577,2551,1303,21254,0
2017-08-23,1758,2655,4975,2387,4371,2391,1371,19908,0
2017-08-24,1757,2940,5232,2302,4337,2472,934,19974,0
2017-08-25,1593,3113,4747,2055,4497,1750,1308,19063,0
2017-08-26,0,1450,1575,0,1440,489,204,5158,1
2017-08-27,0,1143,1346,0,957,442,179,4067,1
2017-08-28,1731,3243,4557,2276,4187,2190,1638,19822,0
2017-08-29,1794,3167,4686,2285,4102,2498,1239,19771,0
2017-08-30,1871,2948,4416,2284,4392,2186,1471,19568,0
2017-08-31,1800,3387,4620,2217,4100,2202,1294,19620,0
2018-08-01,1434,2942,4655,2539,3873,1977,1181,18601,0
2018-08-02,1454,2974,4997,2410,3820,2394,1187,19236,0
2018-08-03,1285,3037,4731,1852,3505,2038,1324,17772,0
2018-08-04,0,1359,2126,0,1463,1086,380,6414,1
2018-08-05,0,1133,1363,0,1400,544,341,4781,1
2018-08-06,1620,3111,4568,2325,4070,2505,1482,19681,0
2018-08-07,1538,3012,4684,2434,4119,2447,1203,19437,0
2018-08-08,1636,2923,5207,854,4283,2481,1495,18879,0
2018-08-09,1482,2784,4645,2227,4317,2365,1274,19094,0
2018-08-10,1378,2877,4659,2064,4122,2323,1472,18895,0
2018-08-11,0,1380,2292,0,1355,840,295,6162,1
2018-08-12,0,1131,1559,0,1272,656,247,4865,1
2018-08-13,1695,2748,4750,2221,4170,2432,1385,19401,0
2018-08-14,1395,3110,4486,2341,3835,2516,1638,19321,0
2018-08-15,1495,3025,5112,2301,3976,2635,1481,20025,0
2018-08-16,1521,3042,4630,2427,3616,2426,1318,18980,0
2018-08-17,1350,3058,4220,1932,3681,2194,1461,17896,0
2018-08-18,0,1459,2484,0,1389,665,450,6447,1
2018-08-19,0,1099,1342,0,1030,579,215,4265,1
2018-08-20,1532,2670,4844,2200,4359,2462,1294,19361,0
2018-08-21,1583,2744,4898,2496,3981,2259,1319,19280,0
2018-08-22,1529,2894,4758,2472,4085,2360,1377,19475,0
2018-08-23,1620,2893,4762,2460,4112,2384,1426,19657,0
2018-08-24,1297,2869,4606,1910,4513,2404,1540,19139,0
2018-08-25,0,1420,2335,0,1363,606,346,6070,1
2018-08-26,0,1079,1265,0,1011,487,150,3992,1
2018-08-27,1583,2689,4608,2211,4409,2436,1486,19422,0
2018-08-28,1593,2900,5031,2506,4030,2972,1453,20485,0
2018-08-29,1684,3147,4786,2484,3622,2545,1508,19776,0
2018-08-30,1659,2925,4996,2425,3962,2233,1428,19628,0
2018-08-31,1534,2868,4300,1894,3647,1878,1521,17642,0
2019-08-01,1716,2806,4970,2279,3948,2039,1365,19123,0
2019-08-02,1427,2800,4791,2213,3482,1971,1313,17997,0
2019-08-03,0,1316,1973,0,1718,1043,346,6396,1
2019-08-04,0,999,1469,0,987,643,336,4434,1
2019-08-05,1690,3126,4654,2361,3850,1986,1332,18999,0
2019-08-06,1706,3018,4666,2396,3777,2502,1262,19327,0
2019-08-07,1723,3166,4983,2133,4129,2642,1382,20158,0
2019-08-08,1560,3084,5064,2355,3967,2287,1312,19629,0
2019-08-09,1459,2299,4752,2214,3318,2129,1250,17421,0
2019-08-10,0,1184,2156,0,1488,803,402,6033,1
2019-08-11,0,1006,1083,0,1060,553,213,3915,1
2019-08-12,2021,3073,4316,2178,4329,2426,1257,19600,0
2019-08-13,1367,2990,4897,2354,4197,2521,1346,19672,0
2019-08-14,1572,2855,4684,2526,4492,2434,1330,19893,0
2019-08-15,1585,2767,4795,2255,4740,2369,1267,19778,0
2019-08-16,1612,2953,4602,2117,4682,2045,1283,19294,0
2019-08-17,0,1951,2128,0,1699,733,390,6901,1
2019-08-18,0,1662,1252,0,1254,603,280,5051,1
2019-08-19,1628,2933,4448,2394,4173,2330,1362,19268,0
2019-08-20,1736,2685,5228,2640,4161,2482,1459,20391,0
2019-08-21,1847,2832,4763,2542,3897,2556,1400,19837,0
2019-08-22,1769,3070,5232,2263,3860,2367,1146,19707,0
2019-08-23,1465,2858,4549,2226,3566,2153,1155,17972,0
2019-08-24,0,1162,2241,0,1478,587,400,5868,1
2019-08-25,0,931,1440,0,1225,383,237,4216,1
2019-08-26,1648,3131,5130,2401,3993,2260,1269,19832,0
2019-08-27,1650,3077,5390,2571,4119,2601,1478,20886,0
2019-08-28,1590,2949,5407,2317,4171,2733,1317,20484,0
2019-08-29,1636,2868,5640,2376,3899,2394,1067,19880,0
2019-08-30,1395,3058,4798,2277,3833,2110,1210,18681,0
2019-08-31,0,1909,2002,0,1881,706,299,6797,1
2015-09-01,1723,3043,5175,2225,4262,2349,1252,20029,0
2015-09-02,2008,3005,5311,2262,4379,2154,1354,20473,0
2015-09-03,2045,3025,5077,2184,4557,2324,1088,20300,0
2015-09-04,1645,3273,4918,2066,5026,2330,1092,20350,0
2015-09-05,0,0,2548,0,1604,920,319,5391,1
2015-09-06,0,0,1745,0,1162,804,192,3903,1
2015-09-08,2041,3258,5728,2219,5026,2177,1254,21703,0
2015-09-09,2407,2973,5049,2090,4676,2397,1316,20908,0
2015-09-10,1882,3177,5298,2262,4190,2407,1187,20403,0
2015-09-11,1783,3228,5523,2081,5151,2541,1216,21523,0
2015-09-12,0,1593,2013,0,1148,245,244,5243,1
2015-09-13,0,1287,1361,0,1023,704,200,4575,1
2015-09-14,1970,3137,5260,2158,4151,2247,1249,20172,0
2015-09-15,1863,3161,5181,2073,4466,2237,1176,20157,0
2015-09-16,1679,3180,5289,2205,4747,2395,1226,20721,0
2015-09-17,1927,3223,5092,2255,4349,2424,1183,20453,0
2015-09-18,1809,3292,4726,2164,4211,2173,1340,19715,0
2015-09-19,0,1570,2152,0,1269,655,275,5921,1
2015-09-20,0,1170,1540,0,868,469,180,4227,1
2015-09-21,2028,3279,4915,2155,4323,2090,1222,20012,0
2015-09-22,1953,3130,5169,2316,4752,2364,958,20642,0
2015-09-23,1817,3071,5008,2149,4468,2295,1237,20045,0
2015-09-24,1926,3082,5017,2241,4196,2407,1105,19974,0
2015-09-25,2035,2769,5037,2052,4801,2520,1219,20433,0
2015-09-26,0,1522,2118,0,1424,321,293,5678,1
2015-09-27,0,1283,1358,0,987,302,191,4121,1
2015-09-28,1807,2910,5939,2354,4201,2298,1156,20665,0
2015-09-29,2771,3139,6039,2298,5077,2405,1210,22939,0
2015-09-30,2058,3207,5796,2346,4554,2423,1193,21577,0
2016-09-01,1840,2916,4774,2307,3488,2350,1102,18777,0
2016-09-02,1746,2653,4914,1772,3520,2158,1237,18000,0
2016-09-03,0,1520,2403,0,1590,915,274,6702,1
2016-09-04,0,1218,1742,0,1532,470,255,5217,1
2016-09-05,0,153,0,0,0,0,0,153,0
2016-09-06,1932,3309,4691,2327,4567,2105,1186,20117,0
2016-09-07,1854,2985,5030,2361,4492,2159,1416,20297,0
2016-09-08,1798,2917,4178,1535,4667,2262,1328,18685,0
2016-09-09,1737,3116,4960,1971,4747,2537,1244,20312,0
2016-09-10,0,1496,2403,0,1417,438,369,6123,1
2016-09-11,0,1332,1411,0,1005,445,154,4347,1
2016-09-12,1915,3074,5065,2256,4423,2077,1131,19941,0
2016-09-13,1964,2791,4496,2326,4345,2201,1334,19457,0
2016-09-14,1807,3139,5081,2321,4594,2087,1362,20391,0
2016-09-15,1859,3088,5457,2444,3897,2286,1232,20263,0
2016-09-16,1513,3251,4635,1814,4208,2094,1239,18754,0
2016-09-17,0,1510,2422,0,1403,470,338,6143,1
2016-09-18,0,1451,2338,0,1421,475,433,6118,1
2016-09-19,1660,3138,5144,2106,4591,2385,1330,20354,0
2016-09-20,1933,3141,5032,2394,4078,2089,1161,19828,0
2016-09-21,1936,3168,4963,2420,4311,2247,1266,20311,0
2016-09-22,1891,3139,4615,2338,4267,2486,1239,19975,0
2016-09-23,1843,3067,4465,2053,3650,1952,1384,18414,0
2016-09-24,0,1315,2391,0,1152,470,181,5509,1
2016-09-25,430,1144,1492,0,952,414,214,4646,1
2016-09-26,1767,3121,4981,2274,4424,2084,1402,20053,0
2016-09-27,1900,3083,4994,2399,4252,2138,1229,19995,0
2016-09-28,1860,3049,4894,2256,4299,2225,1388,19971,0
2016-09-29,1871,3168,4808,2395,4100,2281,1353,19976,0
2016-09-30,1837,3075,4863,2055,4278,2133,1049,19290,0
2017-09-01,1320,3241,4149,1823,3594,1989,1402,17518,0
2017-09-02,0,1454,2085,0,1270,657,298,5764,1
2017-09-03,0,1055,1427,0,1152,595,178,4407,1
2017-09-04,0,886,1053,0,460,212,125,2736,0
2017-09-05,1766,3413,5086,2118,3525,2435,1193,19536,0
2017-09-06,1844,2931,5113,2281,4155,2481,1411,20216,0
2017-09-07,1913,3080,5133,2296,3949,2158,1061,19590,0
2017-09-08,1687,3297,4575,1827,3432,1760,1509,18087,0
2017-09-09,0,1390,1809,0,1100,506,294,5099,1
2017-09-10,0,1202,1335,0,1164,326,227,4254,1
2017-09-11,1758,3063,4825,2271,4148,2377,1379,19821,0
2017-09-12,1879,3162,5128,2413,4402,2459,1428,20871,0
2017-09-13,1848,3124,4948,2344,4204,2033,1502,20003,0
2017-09-14,1341,3153,5301,2132,3768,2226,1274,19195,0
2017-09-15,1707,3046,2768,1879,3183,2432,1080,16095,0
2017-09-16,0,1553,1713,0,970,279,239,4754,1
2017-09-17,0,1345,1800,0,928,378,425,4876,1
2017-09-18,1777,3263,4975,2154,4037,2406,1336,19948,0
2017-09-19,1655,3198,4961,2177,4320,2450,1109,19870,0
2017-09-20,1775,3338,5228,2352,4353,2402,1380,20828,0
2017-09-21,1552,3060,4799,2275,3942,1998,1015,18641,0
2017-09-22,1606,3184,4604,1822,3350,1917,1456,17939,0
2017-09-23,0,995,1827,0,781,245,177,4025,1
2017-09-24,0,898,1161,0,809,270,221,3359,1
2017-09-25,1695,3226,4662,2301,3653,2436,1703,19676,0
2017-09-26,1762,3281,5092,2416,4319,2064,1305,20239,0
2017-09-27,1816,3341,4580,2284,4069,2388,1540,20018,0
2017-09-28,1847,3261,5260,2443,4270,2403,1177,20661,0
2017-09-29,1623,3409,4300,2284,3860,2284,1435,19195,0
2017-09-30,0,1434,1652,0,921,210,265,4482,1
2018-09-01,0,1489,2325,0,1691,688,407,6600,1
2018-09-02,0,1220,1764,0,1412,486,265,5147,1
2018-09-03,0,1287,1400,0,1074,277,132,4170,0
2018-09-04,1657,2981,4646,2525,4048,2424,1331,19612,0
2018-09-05,1669,2819,4930,2378,4510,2508,1548,20362,0
2018-09-06,1630,2951,5077,2576,4026,2318,1418,19996,0
2018-09-07,1398,3096,4229,1989,3801,2056,1489,18058,0
2018-09-08,0,1358,2186,0,1198,658,341,5741,1
2018-09-09,0,1073,1486,0,1020,439,233,4251,1
2018-09-10,1341,2789,4656,2081,4120,2341,1404,18732,0
2018-09-11,1745,2742,4725,2426,4706,2068,1305,19717,0
2018-09-12,1554,2684,5079,2224,4163,2405,1376,19485,0
2018-09-13,1667,2987,4687,2355,4002,2686,1492,19876,0
2018-09-14,1417,3078,4888,1703,4241,2048,1367,18742,0
2018-09-15,0,1520,1948,0,1123,379,267,5237,1
2018-09-16,0,1208,1622,0,1493,559,281,5163,1
2018-09-17,1606,2919,4650,2353,4305,2274,1317,19424,0
2018-09-18,1865,2566,4677,2488,4105,2282,1378,19361,0
2018-09-19,2644,3143,4858,2414,4071,2450,1292,20872,0
2018-09-20,1673,2971,4570,2340,3853,2478,1346,19231,0
2018-09-21,1425,3046,5011,1985,3687,2145,1381,18680,0
2018-09-22,0,1498,2223,0,1019,399,320,5459,1
2018-09-23,0,1315,1816,0,1677,183,388,5379,1
2018-09-24,1671,2929,4889,2324,4268,2397,1504,19982,0
2018-09-25,2665,3004,4885,2423,4084,2355,1520,20936,0
2018-09-26,1708,2786,4613,2548,4053,2517,1556,19781,0
2018-09-27,1651,3042,4917,2417,3504,2366,1229,19126,0
2018-09-28,1413,2990,4231,2286,4797,2007,1412,19136,0
2018-09-29,0,1665,1795,0,1080,396,306,5242,1
2018-09-30,0,1591,1434,0,1016,377,385,4803,1
2019-09-01,0,1571,1461,0,1388,829,219,5468,1
2019-09-02,0,1624,1071,0,1185,376,183,4439,0
2019-09-03,1653,3156,5407,2531,4241,2424,1380,20792,0
2019-09-04,1795,2904,5357,2605,3872,2471,1355,20359,0
2019-09-05,1637,3086,5507,2596,3962,2209,1309,20306,0
2019-09-06,1557,3278,5128,2422,3610,2138,1200,19333,0
2019-09-07,0,1305,2029,0,1094,453,323,5204,1
2019-09-08,0,895,1331,0,874,256,210,3566,1
2019-09-09,1468,2875,5047,2564,4425,2474,1345,20198,0
2019-09-10,1912,2573,5297,2537,4097,2585,1361,20362,0
2019-09-11,1834,2968,5137,2493,4138,2417,1345,20332,0
2019-09-12,1691,3022,5223,2594,4085,2229,1459,20303,0
2019-09-13,1325,3152,5164,1965,3847,1842,1204,18499,0
2019-09-14,0,1223,1933,0,1538,396,433,5523,1
2019-09-15,0,962,1662,0,1343,342,329,4638,1
2019-09-16,278,3377,4866,2517,3974,2414,1418,18844,0
2019-09-17,1650,3134,5409,2566,4282,2472,1210,20723,0
2019-09-18,1691,2860,4980,2622,4548,2537,1152,20390,0
2019-09-19,1714,2893,5185,2372,4329,2425,1176,20094,0
2019-09-20,1397,2989,5280,2045,3386,2173,1374,18644,0
2019-09-21,0,1384,1899,0,1366,506,280,5435,1
2019-09-22,0,1039,1405,0,856,356,255,3911,1
2019-09-23,1604,2562,4953,2505,3956,2229,1481,19290,0
2019-09-24,1735,3042,5099,2642,4238,2500,1299,20555,0
2019-09-25,1668,2886,5075,2564,4218,2526,1427,20364,0
2019-09-26,1617,2890,5313,2480,3951,2465,1373,20089,0
2019-09-27,1506,2701,5093,2362,4059,2246,1217,19184,0
2019-09-28,0,1257,1647,0,951,323,301,4479,1
2019-09-29,0,1145,1690,0,1433,294,380,4942,1
2019-09-30,1463,2996,4852,2327,3816,2276,1363,19093,0
2015-10-01,2135,3426,5887,2165,4312,2480,1182,21587,0
2015-10-02,1881,3339,5449,1978,4407,2420,1317,20791,0
2015-10-03,0,1539,2174,0,1217,486,107,5523,1
2015-10-04,0,1152,1406,0,921,322,164,3965,1
2015-10-05,1890,3073,5478,2558,4408,2407,1115,20929,0
2015-10-06,1836,3204,5880,2440,4129,2275,1430,21194,0
2015-10-07,1946,3098,5595,2822,4295,2320,1120,21196,0
2015-10-08,1836,3225,5957,2766,4244,2275,1353,21656,0
2015-10-09,1619,2855,5083,2343,3220,1959,1119,18198,0
2015-10-10,0,1553,2188,0,1011,557,332,5641,1
2015-10-11,0,1244,1338,0,840,375,252,4049,1
2015-10-12,1659,2611,4945,1807,3544,2290,756,17612,0
2015-10-13,1928,3195,5909,2459,3962,2366,1420,21239,0
2015-10-14,1808,3115,6242,2476,3640,2406,1159,20846,0
2015-10-15,2020,3053,6659,2319,4392,2322,1076,21841,0
2015-10-16,1652,3275,5966,2156,4299,2300,1240,20888,0
2015-10-17,0,1004,2732,0,792,242,270,5040,1
2015-10-18,0,1377,1702,0,820,158,226,4283,1
2015-10-19,1964,3216,5942,2374,4028,2349,1179,21052,0
2015-10-20,2000,2961,5935,2292,4413,2454,1270,21325,0
2015-10-21,1996,3234,6332,2466,3957,2410,1403,21798,0
2015-10-22,1682,3247,6281,2443,4109,2437,1395,21594,0
2015-10-23,1933,3051,5385,2364,4106,1987,1286,20112,0
2015-10-24,0,1611,2210,0,1276,399,232,5728,1
2015-10-25,0,1307,1389,0,854,417,148,4115,1
2015-10-26,1829,3114,6385,2455,4332,2440,1138,21693,0
2015-10-27,1764,3485,5873,2448,4397,2410,1434,21811,0
2015-10-28,2029,3243,6139,2068,4458,2162,1369,21468,0
2015-10-29,1930,3137,6180,2439,3279,2759,1468,21192,0
2015-10-30,1702,3211,5789,2141,3764,2202,1424,20233,0
2015-10-31,0,1525,2150,0,1108,201,337,5321,1
2016-10-01,0,1437,2173,0,1279,325,297,5511,1
2016-10-02,0,1145,1255,0,1094,491,162,4147,1
2016-10-03,1624,2901,5157,2254,3673,2324,1522,19455,0
2016-10-04,1819,2791,5616,1838,4651,2284,1554,20553,0
2016-10-05,1751,3042,4881,2394,4382,2301,1604,20355,0
2016-10-06,1905,2875,4785,2327,4079,2444,1576,19991,0
2016-10-07,1442,2980,4905,1988,3733,2154,1408,18610,0
2016-10-08,0,1400,1969,0,277,0,304,3950,1
2016-10-09,0,1465,2961,0,292,0,230,4948,1
2016-10-10,1409,2711,4208,1653,3637,2139,1136,16893,0
2016-10-11,1809,2954,5266,1491,4419,2278,1521,19738,0
2016-10-12,1889,2798,5004,1987,4344,1965,1485,19472,0
2016-10-13,1665,2973,5225,1557,4210,1846,1652,19128,0
2016-10-14,1644,2925,4999,1517,3751,2125,1511,18472,0
2016-10-15,0,1445,2395,0,192,0,226,4258,1
2016-10-16,0,1068,1607,0,178,0,184,3037,1
2016-10-17,1800,3084,5142,2106,4275,2306,1352,20065,0
2016-10-18,1548,3176,5269,2352,4207,2234,1623,20409,0
2016-10-19,1984,2942,4969,2219,4299,2259,1337,20009,0
2016-10-20,1835,3080,5140,2373,4067,2510,1362,20367,0
2016-10-21,1610,3185,4725,2164,4034,2256,1411,19385,0
2016-10-22,0,1380,1735,0,313,0,279,3707,1
2016-10-23,0,1118,1094,0,160,0,162,2534,1
2016-10-24,1799,3080,5015,2141,4035,2030,1641,19741,0
2016-10-25,1806,3136,5184,2243,3892,2448,1651,20360,0
2016-10-26,1730,2927,4827,2309,4442,2355,1513,20103,0
2016-10-27,1998,3215,5078,2424,4074,2657,1414,20860,0
2016-10-28,1719,2941,5011,2053,4182,2551,1438,19895,0
2016-10-29,0,1463,1869,0,1207,191,363,5093,1
2016-10-30,0,1100,1363,0,893,142,194,3692,1
2016-10-31,1684,2365,4489,2003,4261,2511,1404,18717,0
2017-10-01,0,1234,907,0,867,497,208,3713,1
2017-10-02,1834,3418,4834,2286,3867,2310,1387,19936,0
2017-10-03,1850,3297,5219,2213,4177,2262,1391,20409,0
2017-10-04,1814,3187,4895,2298,3644,2398,1122,19358,0
2017-10-05,1741,3239,4527,2325,3938,2298,1402,19470,0
2017-10-06,1589,3126,4685,1871,3645,2036,1721,18673,0
2017-10-07,0,1428,1635,0,1102,239,360,4764,1
2017-10-08,0,1098,1922,0,1437,281,259,4997,1
2017-10-09,1493,2843,3912,1759,3546,2811,1431,17795,0
2017-10-10,1381,3125,4965,2225,3831,2502,1455,19484,0
2017-10-11,1789,3078,5155,2322,4180,1970,1597,20091,0
2017-10-12,1843,3171,4880,2270,3975,2574,1696,20409,0
2017-10-13,1684,3005,4787,2080,3401,2383,1592,18932,0
2017-10-14,0,1415,2371,0,1327,334,315,5762,1
2017-10-15,0,1223,1573,0,839,347,216,4198,1
2017-10-16,1849,3023,4816,2309,4151,2507,1581,20236,0
2017-10-17,1895,3196,4952,2334,4261,2454,1444,20536,0
2017-10-18,1898,3288,4327,2351,3925,2627,1687,20103,0
2017-10-19,1662,3098,4692,2369,4204,2472,1419,19916,0
2017-10-20,1611,3102,4775,2263,3647,2156,1621,19175,0
2017-10-21,0,1374,2281,0,971,366,269,5261,1
2017-10-22,0,1119,1380,0,893,258,178,3828,1
2017-10-23,1745,3081,4759,2278,4229,2414,1559,20065,0
2017-10-24,1809,3112,4857,2195,4274,2444,1492,20183,0
2017-10-25,1846,3198,5432,2391,4499,2504,1765,21635,0
2017-10-26,1893,3210,4877,2361,4120,2320,1290,20071,0
2017-10-27,1755,3328,4785,2073,4169,1974,1591,19675,0
2017-10-28,0,1500,2129,0,1232,282,430,5573,1
2017-10-29,0,1199,1698,0,1054,234,295,4480,1
2017-10-30,1875,3061,4985,2307,4730,2107,1517,20582,0
2017-10-31,1677,2862,4634,1689,4137,2329,1490,18818,0
2018-10-01,1652,2993,4646,2483,4266,2293,1474,19807,0
2018-10-02,1717,2826,4847,2385,4254,2465,1680,20174,0
2018-10-03,1686,2966,4848,2417,3926,2478,1373,19694,0
2018-10-04,1672,2802,4988,2517,3743,2348,1143,19213,0
2018-10-05,1281,3081,4856,2362,3680,2205,1485,18950,0
2018-10-06,0,1903,2039,0,1201,465,497,6105,1
2018-10-07,0,1547,1606,0,1269,681,301,5404,1
2018-10-08,1466,2634,4048,1603,3814,2333,1344,17242,0
2018-10-09,1512,2934,4813,2570,3711,2506,1319,19365,0
2018-10-10,1567,2939,4999,2753,4225,2509,1278,20270,0
2018-10-11,1612,2965,5117,2555,3887,2236,1713,20085,0
2018-10-12,1446,2854,4611,2208,3721,2242,1504,18586,0
2018-10-13,0,1914,1618,0,744,189,310,4775,1
2018-10-14,0,1491,1345,0,762,124,266,3988,1
2018-10-15,1736,3275,5251,2315,3975,2359,1577,20488,0
2018-10-16,2959,3010,4867,2361,4034,2546,1488,21265,0
2018-10-17,1654,3277,5824,2502,4079,2510,1591,21437,0
2018-10-18,1503,2944,5133,2548,4230,2429,1437,20224,0
2018-10-19,1093,3023,4475,2120,3998,2199,1557,18465,0
2018-10-20,0,1853,2108,0,716,209,353,5239,1
2018-10-21,0,1356,1360,0,1191,179,269,4355,1
2018-10-22,1591,3045,4901,2410,4466,2224,1515,20152,0
2018-10-23,1790,3161,5915,809,3843,2428,1782,19728,0
2018-10-24,1858,2926,5230,2455,3942,2293,1664,20368,0
2018-10-25,1851,2945,5179,2498,4245,2398,1388,20504,0
2018-10-26,1455,3081,5076,1999,2900,2034,1639,18184,0
2018-10-27,0,2092,2257,0,1250,217,394,6210,1
2018-10-28,0,1879,2324,0,1751,267,523,6744,1
2018-10-29,1683,3185,4950,2337,4147,2355,1645,20302,0
2018-10-30,1687,3077,4651,2438,4243,2447,1408,19951,0
2018-10-31,1921,3082,4570,2142,3937,2522,1580,19754,0
2019-10-01,1785,3131,5013,2487,3897,2513,1412,20238,0
2019-10-02,1774,2821,5017,2527,4075,2519,1511,20244,0
2019-10-03,1877,2977,5491,2626,4408,2472,1427,21278,0
2019-10-04,1585,2955,5335,2121,3596,2313,1513,19418,0
2019-10-05,0,1389,1826,0,969,293,498,4975,1
2019-10-06,0,1029,1306,0,1113,520,236,4204,1
2019-10-07,1725,2937,5045,2463,4170,2385,1260,19985,0
2019-10-08,1912,2873,4748,2588,4397,2266,1565,20349,0
2019-10-09,1600,2957,5228,2518,4195,2460,1230,20188,0
2019-10-10,1909,2910,5549,2473,4235,2327,1571,20974,0
2019-10-11,1503,494,5296,2337,3704,2336,1358,17028,0
2019-10-12,0,953,1967,0,1297,423,411,5051,1
2019-10-13,0,1154,2250,0,1374,232,604,5614,1
2019-10-14,1378,2712,4200,1741,3738,2320,1071,17160,0
2019-10-15,1784,2949,5602,2522,4153,2281,1492,20783,0
2019-10-16,1605,3045,5225,2537,3731,2311,1533,19987,0
2019-10-17,1623,2791,5405,2413,3983,2396,1579,20190,0
2019-10-18,1624,3048,4588,2122,4015,2408,1380,19185,0
2019-10-19,0,1215,1805,0,1018,100,442,4580,1
2019-10-20,0,989,1641,0,695,176,375,3876,1
2019-10-21,1686,2865,5166,2282,4544,2424,1415,20382,0
2019-10-22,1812,3000,5215,2173,4866,2232,1642,20940,0
2019-10-23,1869,3000,5052,2452,4470,2301,1721,20865,0
2019-10-24,1731,2902,5479,2430,4471,2452,1291,20756,0
2019-10-25,1305,845,4926,2054,3516,2214,1589,16449,0
2019-10-26,0,1235,2514,0,1231,154,350,5484,1
2019-10-27,0,1034,1467,0,751,190,331,3773,1
2019-10-28,1663,2994,5195,2169,3693,2539,1454,19707,0
2019-10-29,1825,2832,3964,2094,3703,1583,1826,17827,0
2019-10-30,1690,2901,4921,2294,4464,2518,1672,20460,0
2019-10-31,1060,2790,5107,354,3953,2253,1760,17277,0
2015-11-01,0,1536,1842,0,954,211,282,4825,1
2015-11-02,2086,3257,6270,2362,3980,2275,1169,21399,0
2015-11-03,1938,3254,6393,2400,4323,2260,1227,21795,0
2015-11-04,2254,3232,6278,2095,3781,2338,1512,21490,0
2015-11-05,1721,3170,6152,2431,4078,2253,1335,21140,0
2015-11-06,1754,3352,5715,1996,3912,1681,1155,19565,0
2015-11-07,0,1415,1978,0,1160,225,336,5114,1
2015-11-08,0,1280,1670,0,898,302,150,4300,1
2015-11-09,1929,3247,6183,2425,3848,2227,1384,21243,0
2015-11-10,1530,2791,6074,2518,4206,2376,1372,20867,0
2015-11-11,1405,2347,3581,1722,3170,1822,940,14987,0
2015-11-12,1898,2991,6207,2465,4112,2132,1280,21085,0
2015-11-13,1816,3058,5495,2229,4743,2394,1272,21007,0
2015-11-14,0,1613,1876,0,1061,347,298,5195,1
2015-11-15,0,1260,1395,0,829,201,160,3845,1
2015-11-16,1896,3187,6087,2412,4186,2159,1166,21093,0
2015-11-17,1818,3028,5724,1861,4393,2325,1243,20392,0
2015-11-18,1852,3150,6124,2383,4431,2112,1105,21157,0
2015-11-19,1831,3133,6235,2408,4315,2266,1073,21261,0
2015-11-20,1900,2832,6046,2414,3541,2042,1137,19912,0
2015-11-21,0,1532,2497,0,956,144,203,5332,1
2015-11-22,0,1180,1477,0,930,295,160,4042,1
2015-11-23,1833,3320,5604,2211,3778,1981,1134,19861,0
2015-11-24,1797,3111,5567,2229,4131,2015,1187,20037,0
2015-11-25,1478,3327,5787,1983,3427,1944,969,18915,0
2015-11-26,0,761,735,0,0,0,0,1496,0
2015-11-26,0,761,735,0,0,0,0,1496,0
2015-11-27,365,1682,2284,369,956,492,346,6494,0
2015-11-27,365,1682,2284,369,956,492,346,6494,0
2015-11-28,0,1348,2195,0,1412,144,228,5327,1
2015-11-29,0,1463,1688,0,937,228,195,4511,1
2015-11-30,2003,2889,4948,2337,4108,1558,1367,19210,0
2016-11-01,1729,3361,5740,2402,4481,2737,1641,22091,0
2016-11-02,1983,2242,5329,2424,4304,2639,1835,20756,0
2016-11-03,2001,3225,5302,2329,4256,2186,1529,20828,0
2016-11-04,1720,3275,3980,2242,4257,1859,1025,18358,0
2016-11-05,0,1424,2106,0,585,281,246,4642,1
2016-11-06,0,1272,2104,0,1476,181,392,5425,1
2016-11-07,1862,2678,4990,2464,4155,2213,1831,20193,0
2016-11-08,1859,3126,5116,2218,4331,2552,1476,20678,0
2016-11-09,1930,2914,4804,2208,4654,2485,1514,20509,0
2016-11-10,1913,3261,5153,2308,4245,2701,954,20535,0
2016-11-11,1118,2704,3026,1416,3068,1586,1066,13984,0
2016-11-12,0,1244,1982,0,1340,205,290,5061,1
2016-11-13,0,1171,1340,0,858,200,164,3733,1
2016-11-14,1771,3166,5112,2283,3830,2339,1342,19843,0
2016-11-15,2004,3224,5187,2173,4159,2573,1731,21051,0
2016-11-16,1827,2983,4935,2049,4212,2582,1673,20261,0
2016-11-17,1731,3337,4670,1133,4140,2618,1339,18968,0
2016-11-18,1456,3042,4586,2166,3960,2570,1175,18955,0
2016-11-19,0,1512,1783,0,1103,272,289,4959,1
2016-11-20,0,600,2199,0,1280,137,450,4666,1
2016-11-21,1646,2629,5191,2450,4164,2197,106,18383,0
2016-11-22,1764,3206,4707,2163,4024,2260,1249,19373,0
2016-11-23,1737,3152,4584,1858,3297,2281,1358,18267,0
2016-11-24,0,540,376,0,0,0,0,916,0
2016-11-25,288,1589,1888,477,1212,399,749,6602,0
2016-11-26,0,1302,1828,0,965,192,344,4631,1
2016-11-27,0,1313,1369,0,627,149,269,3727,1
2016-11-28,1783,2836,5101,2345,4472,2419,1266,20222,0
2016-11-29,1801,2954,4754,2355,4356,2380,1143,19743,0
2016-11-30,1781,3158,4933,2648,4400,2540,1515,20975,0
2017-11-01,1889,3201,5238,2630,4278,2347,1482,21065,0
2017-11-02,1786,3170,5369,2319,3538,2222,1582,19986,0
2017-11-03,1634,3136,4476,2281,3981,2105,1339,18952,0
2017-11-04,0,1291,1747,0,821,198,244,4301,1
2017-11-05,0,1167,1342,0,722,172,209,3612,1
2017-11-06,1753,3013,4785,2390,4398,2325,1583,20247,0
2017-11-07,1871,3223,4832,2335,4462,2435,1340,20498,0
2017-11-08,1904,3251,4613,2243,4231,1951,1629,19822,0
2017-11-09,1788,3212,4730,2406,4123,2130,1416,19805,0
2017-11-10,1193,2778,3318,1572,2844,1967,1051,14723,0
2017-11-11,0,1369,1966,0,846,258,251,4690,1
2017-11-12,0,1181,1658,0,1063,201,399,4502,1
2017-11-13,1820,3064,4861,2191,4198,2387,1626,20147,0
2017-11-14,1814,2951,4422,2239,3443,2356,1617,18842,0
2017-11-15,1759,2808,4071,2259,3636,2219,1526,18278,0
2017-11-16,1787,3001,4671,2206,3513,2258,1587,19023,0
2017-11-17,1630,2596,4101,2056,2600,2257,1421,16661,0
2017-11-18,0,1333,2156,0,827,240,360,4916,1
2017-11-19,0,1121,1424,0,711,208,223,3687,1
2017-11-20,1854,3184,4574,2065,3856,2217,1365,19115,0
2017-11-21,1796,2579,4792,2105,3908,2232,1114,18526,0
2017-11-22,1676,3250,4058,2029,3204,2132,1280,17629,0
2017-11-23,0,802,747,0,418,58,133,2158,0
2017-11-23,0,802,747,0,418,58,133,2158,0
2017-11-24,383,1582,2112,496,1250,803,945,7571,0
2017-11-24,383,1582,2112,496,1250,803,945,7571,0
2017-11-25,0,1325,1877,140,1201,460,480,5483,1
2017-11-26,0,1526,1876,0,1447,199,426,5474,1
2017-11-27,1514,2664,4416,2319,4377,2245,1709,19244,0
2017-11-28,1717,2734,4275,2159,3987,2349,1312,18533,0
2017-11-29,1652,2780,4613,2353,3910,2385,1434,19127,0
2017-11-30,1582,2996,4490,2364,4007,2363,1294,19096,0
2018-11-01,1762,3104,4193,2354,4213,2373,1234,19233,0
2018-11-02,1479,3310,4881,2186,3305,2169,1619,18949,0
2018-11-03,0,1908,1738,0,1199,273,487,5605,1
2018-11-04,0,1739,1364,0,1035,224,243,4605,1
2018-11-05,1731,3114,4997,2445,4405,2551,1528,20771,0
2018-11-06,1686,2945,5396,2413,4202,2638,1397,20677,0
2018-11-07,1691,2968,5135,2457,4155,2521,1594,20521,0
2018-11-08,1668,3205,5205,2344,3161,2070,987,18640,0
2018-11-09,1343,2886,4895,2361,3935,2221,1500,19141,0
2018-11-10,0,1319,2039,0,1167,267,378,5170,1
2018-11-11,0,1086,1562,0,1566,227,364,4805,1
2018-11-12,1026,2414,2941,1237,2848,1740,916,13122,0
2018-11-13,1710,3006,4733,2476,3747,2433,1277,19382,0
2018-11-14,1742,2944,4867,2472,4052,2469,1609,20155,0
2018-11-15,1680,2957,4749,2395,4056,2057,1538,19432,0
2018-11-16,1575,3127,4509,2246,3658,1991,1109,18215,0
2018-11-17,0,1007,1996,0,1059,281,317,4660,1
2018-11-18,0,1042,1261,0,830,198,238,3569,1
2018-11-19,1556,3035,4569,2552,4155,2294,1320,19481,0
2018-11-20,1656,2834,4642,1909,3651,2361,978,18031,0
2018-11-21,1283,2919,4090,1980,3476,2191,1216,17155,0
2018-11-22,0,810,809,0,632,70,226,2547,0
2018-11-22,0,810,809,0,632,70,226,2547,0
2018-11-23,350,1424,1888,479,1249,647,800,6837,0
2018-11-23,350,1424,1888,479,1249,647,800,6837,0
2018-11-24,0,1296,1968,0,1075,349,580,5268,1
2018-11-25,0,1314,1405,0,1248,199,268,4434,1
2018-11-26,1684,2954,4782,2460,4249,2478,1461,20068,0
2018-11-27,1851,3096,4507,2439,3979,2563,1246,19681,0
2018-11-28,1664,2952,5064,2418,3983,2527,1245,19853,0
2018-11-29,1462,2822,4567,2377,3596,2727,1049,18600,0
2018-11-30,1419,2875,4411,2148,3543,2229,1265,17890,0
2019-11-01,1397,2815,5102,2240,3992,2411,1275,19232,0
2019-11-02,0,1273,2215,0,1513,214,528,5743,1
2019-11-03,0,955,1296,0,978,203,305,3737,1
2019-11-04,1757,3069,5210,2209,3845,2211,1464,19765,0
2019-11-05,1822,2998,5072,2572,4142,1642,884,19132,0
2019-11-06,1632,2942,5018,2476,4200,2321,1524,20113,0
2019-11-07,1642,3068,5563,2427,4562,2000,1668,20930,0
2019-11-08,1365,3379,5037,2371,4036,2266,1542,19996,0
2019-11-09,0,1090,2300,0,1452,206,319,5367,1
2019-11-10,0,961,1396,0,1276,270,282,4185,1
2019-11-11,1095,2198,3120,1277,2764,1883,823,13160,0
2019-11-12,1722,3006,5153,2355,4184,2217,1610,20247,0
2019-11-13,1919,2930,5326,2412,4008,2220,1545,20360,0
2019-11-14,1655,2991,5635,2507,4380,2077,1359,20604,0
2019-11-15,1482,2849,4978,2144,3697,2608,1488,19246,0
2019-11-16,0,1106,1574,0,1394,235,421,4730,1
2019-11-17,0,1001,1350,0,1140,245,367,4103,1
2019-11-18,1607,3069,5043,2492,3926,2389,1837,20363,0
2019-11-19,1813,3097,5269,2237,3914,2376,1285,19991,0
2019-11-20,1898,2965,4964,2116,3739,2446,1614,19742,0
2019-11-21,1672,2964,5373,2110,3821,2358,1493,19791,0
2019-11-22,1462,2861,4945,1947,1639,2577,938,16369,0
2019-11-23,0,1226,1946,0,1131,225,381,4909,1
2019-11-24,0,950,1343,0,805,215,304,3617,1
2019-11-25,1543,3029,4998,2189,3651,1906,1585,18901,0
2019-11-26,1509,3190,4575,2418,3937,1795,1444,18868,0
2019-11-27,1340,2631,4230,2216,3673,1562,1291,16943,0
2019-11-28,0,661,792,0,505,77,204,2239,0
2019-11-28,0,661,792,0,505,77,204,2239,0
2019-11-29,324,1603,1747,405,1247,425,507,6258,0
2019-11-29,324,1603,1747,405,1247,425,507,6258,0
2019-11-30,0,1014,1727,0,963,405,533,4642,1
2015-12-01,1975,3388,6430,2568,4344,2261,1343,22309,0
2015-12-02,1830,3187,6439,2580,4242,2210,1175,21663,0
2015-12-03,1882,3172,6197,2443,4377,2354,1316,21741,0
2015-12-04,1764,2963,5581,2287,3978,2112,1200,19885,0
2015-12-05,0,1362,1601,0,920,200,224,4307,1
2015-12-06,0,1159,1389,0,716,117,127,3508,1
2015-12-07,1911,3189,5863,2517,3541,1738,1324,20083,0
2015-12-08,1798,3114,5738,2401,3843,2215,1366,20475,0
2015-12-09,2012,3005,6005,2546,4299,2108,1004,20979,0
2015-12-10,1827,3118,5636,2366,4099,2203,1233,20482,0
2015-12-11,1582,2863,5440,2320,3911,1705,1278,19099,0
2015-12-12,0,1358,1706,0,930,122,249,4365,1
2015-12-13,0,1450,1292,0,608,113,143,3606,1
2015-12-14,1885,2864,4826,2442,4336,2154,1227,19734,0
2015-12-15,1908,3080,5499,2287,4164,2151,1203,20292,0
2015-12-16,1794,2947,5655,2358,4191,2235,1258,20438,0
2015-12-17,1864,2861,5349,2453,4044,2256,1383,20210,0
2015-12-18,1469,2971,5311,2290,4116,2045,767,18969,0
2015-12-19,0,1274,1799,0,938,111,177,4299,1
2015-12-20,0,1447,1449,0,498,145,170,3709,1
2015-12-21,1606,2853,4929,1968,3458,1492,939,17245,0
2015-12-22,1360,2638,4775,2123,3562,1831,1111,17400,0
2015-12-23,1147,2685,4020,1835,3282,1728,971,15668,0
2015-12-24,628,1765,2692,818,1755,685,363,8706,0
2015-12-25,0,488,653,0,0,0,0,1141,0
2015-12-26,0,1137,2512,0,1108,124,254,5135,1
2015-12-27,0,1764,1555,0,771,140,220,4450,1
2015-12-28,1980,2453,4360,1536,2954,1661,825,15769,0
2015-12-29,1240,2237,3919,1920,3200,1411,862,14789,0
2015-12-30,1145,2336,4047,1721,2745,1422,955,14371,0
2015-12-31,833,1543,3730,939,1753,796,448,10042,0
2016-12-01,1807,3085,4953,2425,4418,2307,1397,20392,0
2016-12-02,1613,2984,4845,2112,3979,2530,1626,19689,0
2016-12-03,0,1393,1672,0,846,293,1165,5369,1
2016-12-04,0,1147,1084,0,363,170,69,2833,1
2016-12-05,1726,3152,4564,2006,4558,2274,1462,19742,0
2016-12-06,1817,3050,4939,2504,4380,2395,1410,20495,0
2016-12-07,1884,2914,4649,2143,4052,2041,779,18462,0
2016-12-08,1819,2711,4615,2628,4450,2252,1450,19925,0
2016-12-09,1517,3019,4672,2382,4039,2170,1827,19626,0
2016-12-10,0,1384,1846,0,737,290,808,5065,1
2016-12-11,0,1165,1794,0,1105,168,364,4596,1
2016-12-12,1643,2955,4507,2063,4130,2362,1368,19028,0
2016-12-13,1853,2837,4820,2374,3988,2293,1376,19541,0
2016-12-14,1766,2849,4530,2273,3714,1709,1481,18322,0
2016-12-15,1535,3007,4786,2440,4283,2468,1294,19813,0
2016-12-16,1390,2822,4307,1862,3626,2264,1317,17588,0
2016-12-17,0,1373,1646,0,885,112,1222,5238,1
2016-12-18,0,961,1036,0,740,166,145,3048,1
2016-12-19,1483,2843,4244,2172,3282,1984,1009,17017,0
2016-12-20,1643,2917,4036,2191,3615,2226,1372,18000,0
2016-12-21,1542,2688,4197,2207,3709,1996,1157,17496,0
2016-12-22,1359,2757,4166,2011,3403,1904,978,16578,0
2016-12-23,929,2339,3211,1122,2354,1082,610,11647,0
2016-12-24,0,1173,1857,0,1268,75,397,4770,1
2016-12-25,0,640,606,0,269,58,50,1623,1
2016-12-26,0,1324,1169,0,640,156,173,3462,0
2016-12-27,1105,2405,3674,1796,2687,1740,880,14287,0
2016-12-28,1123,2413,3534,1850,3085,1639,878,14522,0
2016-12-29,854,2395,3505,1905,2702,1451,745,13557,0
2016-12-30,873,2115,2880,1215,1989,1126,811,11009,0
2016-12-31,0,1296,1304,0,854,101,173,3728,1
2017-12-01,1632,3143,4388,2353,3500,2144,1305,18465,0
2017-12-02,0,1237,1930,0,931,475,778,5351,1
2017-12-03,0,991,1245,0,963,244,182,3625,1
2017-12-04,1844,2510,4607,1954,4383,2285,1347,18930,0
2017-12-05,1122,2495,4818,2547,3805,2435,1263,18485,0
2017-12-06,1626,2966,4547,2316,3873,2513,1360,19201,0
2017-12-07,1781,3081,4504,2231,4237,2331,989,19154,0
2017-12-08,1646,3083,4087,2026,3870,2322,1460,18494,0
2017-12-09,0,1076,1850,0,774,749,1083,5532,1
2017-12-10,0,1006,1891,0,885,148,403,4333,1
2017-12-11,1565,2919,4235,2343,4187,2451,1420,19120,0
2017-12-12,1790,2953,4401,2220,4102,2362,1161,18989,0
2017-12-13,1746,3013,4357,2265,3766,2356,1235,18738,0
2017-12-14,1790,2958,4445,2269,3937,2141,1285,18825,0
2017-12-15,1403,3210,3904,1637,3195,2153,1711,17213,0
2017-12-16,0,1212,1836,0,720,812,1054,5634,1
2017-12-17,0,913,949,0,864,195,226,3147,1
2017-12-18,1421,2812,4157,2398,4233,2232,1117,18370,0
2017-12-19,1553,2817,3461,2564,3976,2138,789,17298,0
2017-12-20,1498,2949,4096,2059,3614,2255,1154,17625,0
2017-12-21,1288,2659,3941,1975,3173,1975,993,16004,0
2017-12-22,1069,2428,3045,1380,2464,1520,839,12745,0
2017-12-23,0,1356,1631,0,756,133,253,4129,1
2017-12-24,0,899,754,0,439,110,160,2362,1
2017-12-25,0,743,569,0,209,57,60,1638,0
2017-12-26,914,2135,3274,1191,2349,1095,658,11616,0
2017-12-27,846,2557,3417,1664,2594,1352,847,13277,0
2017-12-28,1187,2351,3182,1664,2703,1444,827,13358,0
2017-12-29,866,2147,2669,1282,2254,1319,662,11199,0
2017-12-30,0,1310,1627,0,877,220,257,4291,1
2017-12-31,0,1249,1757,0,1000,181,350,4537,1
2018-12-01,0,1215,1538,0,734,322,690,4499,1
2018-12-02,0,1141,1230,0,1023,161,217,3772,1
2018-12-03,1557,3010,4550,2542,4220,2487,1212,19578,0
2018-12-04,1675,3032,4705,8287,3828,2732,1157,25416,0
2018-12-05,1385,2672,4606,2335,3741,2454,1146,18339,0
2018-12-06,1516,2743,4537,2346,3778,2360,1179,18459,0
2018-12-07,1462,2982,4585,2242,3867,2277,1462,18877,0
2018-12-08,0,1358,1808,0,795,606,713,5280,1
2018-12-09,0,1085,1350,0,878,134,212,3659,1
2018-12-10,1779,3009,4541,2389,4374,2420,1347,19859,0
2018-12-11,1556,2937,4162,2398,3691,2577,1107,18428,0
2018-12-12,1594,2958,4666,2205,3986,2331,1131,18871,0
2018-12-13,1588,2919,4936,2331,3775,2271,1086,18906,0
2018-12-14,1361,2875,4145,2099,3931,2536,1150,18097,0
2018-12-15,0,1299,1804,0,868,574,1100,5645,1
2018-12-16,0,905,1393,0,980,124,202,3604,1
2018-12-17,1491,2764,4475,2251,3675,2368,1172,18196,0
2018-12-18,1448,2864,4521,2097,3806,2519,1122,18377,0
2018-12-19,1515,2946,4294,1922,3961,2453,1127,18218,0
2018-12-20,1585,2767,4045,1943,3539,1862,1027,16768,0
2018-12-21,1109,2714,3437,1477,2582,1561,1008,13888,0
2018-12-22,0,1212,1332,0,917,140,283,3884,1
2018-12-23,0,1023,1424,0,902,216,214,3779,1
2018-12-24,458,1558,1677,416,1169,402,325,6005,0
2018-12-25,0,734,919,0,646,60,67,2426,0
2018-12-26,871,2395,3184,1268,2290,1346,904,12258,0
2018-12-27,955,2461,3557,1545,2660,1493,622,13293,0
2018-12-28,901,2384,3264,1286,2094,813,774,11516,0
2018-12-29,0,1179,2024,0,1278,365,317,5163,1
2018-12-30,0,1192,2305,0,1301,47,587,5432,1
2018-12-31,464,1759,2362,742,1520,624,565,8036,0
2019-12-01,0,1110,1319,0,1582,233,266,4510,1
2019-12-02,1500,2929,5323,2337,3944,2284,1610,19927,0
2019-12-03,1844,3129,5212,2401,4374,2320,1759,21039,0
2019-12-04,1705,2815,4842,2136,4257,2234,1452,19441,0
2019-12-05,1761,3016,5423,2424,4689,2313,1443,21069,0
2019-12-06,1514,2769,4793,2113,4594,2165,1444,19392,0
2019-12-07,0,819,1395,0,769,148,320,3451,1
2019-12-08,700,1676,1168,0,826,50,212,4632,1
2019-12-09,1730,3072,4948,2245,4102,2145,1457,19699,0
2019-12-10,1847,2985,4885,2365,4282,2213,1468,20045,0
2019-12-11,1656,2941,4908,2447,4051,2289,1749,20041,0
2019-12-12,1687,3063,5027,2460,4199,2304,1443,20183,0
2019-12-13,1285,3074,5005,2374,3811,2173,1507,19229,0
2019-12-14,0,951,1589,0,1092,715,931,5278,1
2019-12-15,0,770,1758,0,826,124,247,3725,1
2019-12-16,1519,2592,5079,2310,4370,2174,1605,19649,0
2019-12-17,1650,2793,4709,2278,4069,2361,1428,19288,0
2019-12-18,1549,2884,4985,2202,3866,2307,1358,19151,0
2019-12-19,1450,2902,4600,2124,3846,2240,1439,18601,0
2019-12-20,1217,3034,4556,2095,3385,2424,1362,18073,0
2019-12-21,0,1462,1534,0,1018,876,589,5479,1
2019-12-22,0,838,1217,0,907,152,209,3323,1
2019-12-23,1143,2505,3151,1733,2547,1058,1077,13214,0
2019-12-24,586,1687,2252,814,1414,498,440,7691,0
2019-12-25,0,711,673,0,516,61,136,2097,0
2019-12-26,757,1672,2722,1148,1967,1073,774,10113,0
2019-12-27,912,2157,3158,1196,2354,902,794,11473,0
2019-12-28,0,1150,1903,0,1247,200,431,4931,1
2019-12-29,0,988,1513,0,1504,195,452,4652,1
2019-12-30,1073,2111,3325,1689,2685,1173,867,12923,0
2019-12-31,640,1956,3066,1287,2038,695,625,10307,0
2022-01-01,6,443,384,0,265,83,90,1271,1
2022-01-02,0,499,546,0,219,108,138,1510,1
2022-01-03,256,770,1285,250,735,514,330,4140,0
2022-01-04,293,810,1409,249,769,612,316,4458,0
2022-01-05,298,792,1184,183,798,652,361,4268,0
2022-01-06,270,787,1352,244,729,606,370,4358,0
2022-01-07,257,791,1278,274,676,503,335,4114,0
2022-01-08,20,555,690,0,432,86,122,1905,1
2022-01-09,0,377,408,0,261,118,83,1247,1
2022-01-10,281,616,1186,214,724,611,362,3994,0
2022-01-11,247,716,1296,284,782,716,395,4436,0
2022-01-12,369,688,1307,261,765,620,402,4412,0
2022-01-13,270,717,1346,327,775,610,416,4461,0
2022-01-14,255,781,1374,205,694,516,387,4212,0
2022-01-15,37,503,297,0,293,72,154,1356,1
2022-01-16,0,483,255,0,359,84,102,1283,1
2022-01-17,122,588,761,158,394,312,247,2582,0
2022-01-18,308,772,1373,295,825,674,456,4703,0
2022-01-19,299,727,1388,316,818,657,450,4655,0
2022-01-20,291,490,1482,291,815,625,385,4379,0
2022-01-21,274,738,1350,282,752,550,408,4354,0
2022-01-22,24,594,537,0,248,64,156,1623,1
2022-01-23,0,495,273,0,103,88,104,1063,1
2022-01-24,311,762,1388,296,806,656,385,4604,0
2022-01-25,305,754,1528,318,790,702,430,4827,0
2022-01-26,284,678,1522,288,834,670,444,4720,0
2022-01-27,285,736,1364,315,783,676,422,4581,0
2022-01-28,277,733,1379,263,698,568,411,4329,0
2022-01-29,22,654,909,0,453,170,166,2374,1
2022-01-30,0,446,617,0,331,115,159,1668,1
2022-01-31,327,663,1367,286,770,673,495,4581,0
2022-02-01,352,744,1467,342,818,724,496,4943,0
2022-02-02,306,810,1483,342,874,718,472,5005,0
2022-02-03,304,766,1492,289,882,661,470,4864,0
2022-02-04,403,1160,2563,377,1363,787,446,7099,0
2022-02-05,32,592,908,0,582,163,248,2525,1
2022-02-06,0,593,739,0,469,183,157,2141,1
2022-02-07,363,869,1440,209,896,727,506,5010,0
2022-02-08,332,781,1565,259,846,778,540,5101,0
2022-02-09,325,823,1629,308,870,843,536,5334,0
2022-02-10,338,854,1549,353,943,744,546,5327,0
2022-02-11,307,940,1503,317,770,664,443,4944,0
2022-02-12,42,737,1291,0,593,289,232,3184,1
2022-02-13,0,520,595,0,366,118,180,1779,1
2022-02-14,391,1029,1681,296,940,762,489,5588,0
2022-02-15,322,767,1733,295,934,759,559,5369,0
2022-02-16,423,855,1819,340,1109,765,562,5873,0
2022-02-17,251,834,1881,371,1089,619,516,5561,0
2022-02-18,334,896,1655,271,861,631,471,5119,0
2022-02-19,0,462,1068,0,704,199,166,2599,1
2022-02-20,0,371,745,0,471,240,165,1992,1
2022-02-21,240,1327,1302,174,477,435,243,4198,0
2022-02-22,448,898,1832,367,1113,745,531,5934,0
2022-02-23,376,815,1964,321,980,769,523,5748,0
2022-02-24,354,800,1825,349,1023,785,517,5653,0
2022-02-25,273,899,1787,309,915,694,455,5332,0
2022-02-26,63,727,1246,0,662,221,207,3126,1
2022-02-27,0,533,723,0,485,171,120,2032,1
2022-02-28,409,910,1638,736,851,677,510,5731,0
2022-03-01,469,919,1962,323,1180,619,479,5951,0
2022-03-02,421,842,1986,395,1112,715,531,6002,0
2022-03-03,464,894,1998,374,1110,401,404,5645,0
2022-03-04,328,988,1956,335,993,686,499,5785,0
2022-03-05,32,757,1080,0,599,139,284,2891,1
2022-03-06,0,676,711,0,581,156,149,2273,1
2022-03-07,419,838,1929,350,1014,799,556,5905,0
2022-03-08,449,1004,2128,468,1209,838,572,6668,0
2022-03-09,420,828,1909,301,1168,874,619,6119,0
2022-03-10,431,913,2047,414,1128,803,595,6331,0
2022-03-11,406,1007,2010,425,1036,659,583,6126,0
2022-03-12,53,732,1099,0,684,114,284,2966,1
2022-03-13,0,580,817,0,391,104,167,2059,1
2022-03-14,416,897,2033,446,983,865,512,6152,0
2022-03-15,495,992,2186,346,1325,908,621,6873,0
2022-03-16,471,1025,2145,437,1178,858,685,6799,0
2022-03-17,386,1049,2116,405,1216,753,605,6530,0
2022-03-18,373,1034,1917,395,1034,688,499,5940,0
2022-03-19,55,927,1275,0,853,343,253,3706,1
2022-03-20,0,683,821,0,856,217,214,2791,1
2022-03-21,396,931,2032,374,1003,808,626,6170,0
2022-03-22,392,1149,2212,349,1520,831,629,7082,0
2022-03-23,433,1064,2185,433,1152,812,538,6617,0
2022-03-24,431,1047,2215,414,1188,723,579,6597,0
2022-03-25,390,1038,2256,336,960,668,559,6207,0
2022-03-26,50,875,1394,0,657,142,280,3398,1
2022-03-27,0,667,1222,0,595,155,189,2828,1
2022-03-28,411,834,1813,285,699,682,471,5195,0
2022-03-29,412,886,1968,436,1322,894,627,6545,0
2022-03-30,511,927,2129,367,1194,847,603,6578,0
2022-03-31,412,936,1914,481,1088,794,611,6236,0
2022-04-01,378,1034,1900,381,1038,727,519,5977,0
2022-04-02,53,917,1261,0,840,395,340,3806,1
2022-04-03,0,729,939,0,583,268,163,2682,1
2022-04-04,472,960,2196,481,1221,823,651,6804,0
2022-04-05,470,1192,2348,525,1484,890,622,7531,0
2022-04-06,512,1150,2459,501,1379,884,816,7701,0
2022-04-07,530,1152,2395,550,1474,854,671,7626,0
2022-04-08,361,1252,2117,443,1086,763,601,6623,0
2022-04-09,57,874,321,0,787,411,289,2739,1
2022-04-10,0,735,788,0,697,273,202,2695,1
2022-04-11,515,1134,2223,505,1156,704,605,6842,0
2022-04-12,511,1093,2783,535,1378,916,672,7888,0
2022-04-13,520,1187,2230,272,1340,839,623,7011,0
2022-04-14,639,1159,2423,541,1434,870,564,7630,0
2022-04-15,340,1146,2111,379,1055,656,480,6167,0
2022-04-16,43,703,1125,0,867,346,225,3309,1
2022-04-17,0,571,682,0,655,148,134,2190,1
2022-04-18,467,1222,2131,523,1216,795,647,7001,0
2022-04-19,469,1232,2584,265,1458,991,627,7626,0
2022-04-20,508,1133,2656,495,1412,857,640,7701,0
2022-04-21,473,1030,2485,418,1368,725,714,7213,0
2022-04-22,504,1741,3465,415,1947,1198,654,9924,0
2022-04-23,19,758,1255,0,765,222,258,3277,1
2022-04-24,0,719,967,0,629,237,159,2711,1
2022-04-25,481,1123,2268,468,1332,915,579,7166,0
2022-04-26,491,1148,2538,500,1468,889,652,7686,0
2022-04-27,469,1151,2405,474,1468,884,665,7516,0
2022-04-28,521,1123,2319,489,1438,973,592,7455,0
2022-04-29,395,1205,2367,411,1147,772,568,6865,0
2022-04-30,32,831,1049,0,866,262,280,3320,1
2022-05-01,0,675,936,0,714,220,238,2783,1
2022-05-02,489,1172,2239,371,1359,969,608,7207,0
2022-05-03,596,1277,2335,531,1534,1054,687,8014,0
2022-05-04,567,1277,2252,519,1467,938,594,7614,0
2022-05-05,521,1137,2362,551,1445,955,617,7588,0
2022-05-06,473,1254,2228,420,1129,773,684,6961,0
2022-05-07,89,892,1069,0,740,358,239,3387,1
2022-05-08,0,656,652,0,688,277,218,2491,1
2022-05-09,532,1381,2249,431,1348,907,721,7569,0
2022-05-10,567,1245,2357,558,1530,921,855,8033,0
2022-05-11,571,1142,2125,468,1260,865,669,7100,0
2022-05-12,559,1305,2301,482,1420,898,667,7632,0
2022-05-13,463,1243,2274,398,1239,777,1538,7932,0
2022-05-14,30,856,987,0,771,355,326,3325,1
2022-05-15,0,655,929,0,601,379,200,2764,1
2022-05-16,490,1141,2146,409,1306,831,488,6811,0
2022-05-17,544,1308,2585,573,1879,568,674,8131,0
2022-05-18,496,1207,2365,572,1559,500,621,7320,0
2022-05-19,514,672,2262,462,1393,817,544,6664,0
2022-05-20,414,1177,2187,398,979,645,717,6517,0
2021-07-01,293,878,1489,322,769,608,483,4842,0
2021-07-02,256,1006,1293,271,705,431,395,4357,0
2021-07-03,45,764,851,0,665,475,207,3007,1
2021-07-04,0,494,544,0,495,252,93,1878,1
2021-07-05,0,608,563,0,387,171,142,1871,0
2021-07-06,278,924,1454,368,719,670,421,4834,0
2021-07-07,297,896,1536,359,789,624,480,4981,0
2021-07-08,304,924,1437,343,880,638,394,4920,0
2021-07-09,313,969,1456,309,697,532,430,4706,0
2021-07-10,31,464,970,0,610,589,223,2887,1
2021-07-11,0,382,683,0,628,450,164,2307,1
2021-07-12,315,853,1547,318,838,659,414,4944,0
2021-07-13,385,921,1540,356,809,689,405,5105,0
2021-07-14,350,874,1464,348,843,700,492,5071,0
2021-07-15,364,834,1561,327,847,628,434,4995,0
2021-07-16,265,941,1543,282,781,705,386,4903,0
2021-07-17,42,434,795,0,764,603,190,2828,1
2021-07-18,0,429,657,0,532,587,142,2347,1
2021-07-19,301,823,1397,316,800,667,399,4703,0
2021-07-20,314,778,1412,322,920,726,425,4897,0
2021-07-21,338,826,1514,331,850,730,450,5039,0
2021-07-22,335,791,1400,347,940,725,454,4992,0
2021-07-23,289,929,1423,279,860,677,365,4822,0
2021-07-24,47,560,848,0,709,614,167,2945,1
2021-07-25,0,462,511,0,588,396,135,2092,1
2021-07-26,354,735,1376,347,816,664,393,4685,0
2021-07-27,368,930,1463,421,848,699,417,5146,0
2021-07-28,341,848,1494,369,857,711,443,5063,0
2021-07-29,398,822,1554,344,916,631,461,5126,0
2021-07-30,341,836,1522,303,766,673,407,4848,0
2021-07-31,31,609,1328,0,559,467,166,3160,1
2021-08-01,0,427,722,0,557,437,91,2234,1
2021-08-02,332,849,1613,310,812,667,412,4995,0
2021-08-03,337,739,1516,343,891,714,460,5000,0
2021-08-04,292,777,1305,382,855,700,467,4778,0
2021-08-05,330,844,1527,395,875,736,446,5153,0
2021-08-06,301,858,1418,240,829,591,418,4655,0
2021-08-07,42,592,870,0,1174,601,151,3430,1
2021-08-08,0,409,748,0,606,523,139,2425,1
2021-08-09,329,831,1366,337,801,667,395,4726,0
2021-08-10,335,792,1326,312,856,723,429,4773,0
2021-08-11,384,784,1363,296,1006,700,438,4971,0
2021-08-12,365,766,1457,369,947,637,486,5027,0
2021-08-13,264,807,1444,289,845,557,438,4644,0
2021-08-14,31,565,859,0,937,429,158,2979,1
2021-08-15,0,489,567,0,744,259,102,2161,1
2021-08-16,358,767,1489,355,984,707,383,5043,0
2021-08-17,367,792,1489,358,1063,754,465,5288,0
2021-08-18,330,812,1540,375,1058,753,446,5314,0
2021-08-19,354,773,1615,359,928,636,449,5114,0
2021-08-20,311,890,1560,290,937,675,402,5065,0
2021-08-21,60,449,1057,0,636,338,176,2716,1
2021-08-22,0,380,573,0,494,265,143,1855,1
2021-08-23,354,749,1746,379,911,728,517,5384,0
2021-08-24,381,883,1791,358,1050,738,543,5744,0
2021-08-25,379,843,1697,385,1060,683,523,5570,0
2021-08-26,353,872,1781,335,965,671,536,5513,0
2021-08-27,330,932,1475,352,969,612,447,5117,0
2021-08-28,32,531,1345,0,606,484,175,3173,1
2021-08-29,0,377,1091,0,649,370,158,2645,1
2021-08-30,377,857,1699,395,909,724,437,5398,0
2021-08-31,382,886,1831,383,964,761,437,5644,0
2021-09-01,381,885,1681,375,1092,656,543,5613,0
2021-09-02,377,814,1752,352,1064,657,489,5505,0
2021-09-03,320,940,1734,277,802,600,435,5108,0
2021-09-04,50,503,915,0,625,430,182,2705,1
2021-09-05,0,569,679,0,709,304,57,2318,1
2021-09-06,0,510,478,0,369,212,87,1656,0
2021-09-07,395,946,1782,370,895,755,488,5631,0
2021-09-08,366,893,1837,333,1044,718,494,5685,0
2021-09-09,365,858,1680,388,1032,715,408,5446,0
2021-09-10,306,914,1901,310,1072,597,467,5567,0
2021-09-11,0,612,988,0,521,362,153,2636,1
2021-09-12,0,523,652,0,418,410,156,2159,1
2021-09-13,363,849,1673,388,1017,732,485,5507,0
2021-09-14,384,818,1859,381,1073,741,545,5801,0
2021-09-15,402,853,1713,383,1070,765,564,5750,0
2021-09-16,382,815,1850,351,849,692,512,5451,0
2021-09-17,356,946,1650,305,767,591,440,5055,0
2021-09-18,0,681,921,0,350,58,170,2180,1
2021-09-19,0,580,609,0,278,61,126,1654,1
2021-09-20,330,951,1779,406,904,734,545,5649,0
2021-09-21,344,961,1830,363,1002,768,526,5794,0
2021-09-22,388,828,1673,404,913,707,347,5260,0
2021-09-23,374,1004,1793,387,916,721,520,5715,0
2021-09-24,358,916,1709,350,861,654,495,5343,0
2021-09-25,43,627,887,0,451,96,186,2290,1
2021-09-26,0,585,687,0,267,76,138,1753,1
2021-09-27,396,838,1742,307,960,707,532,5482,0
2021-09-28,384,855,1699,347,892,752,578,5507,0
2021-09-29,368,821,1880,325,916,794,563,5667,0
2021-09-30,336,870,1884,329,1075,720,564,5778,0
2021-10-01,333,924,1754,313,847,630,499,5300,0
2021-10-02,26,637,1081,0,343,69,232,2388,1
2021-10-03,0,612,662,0,308,83,183,1848,1
2021-10-04,368,866,1714,351,918,789,510,5516,0
2021-10-05,395,892,1899,359,952,841,525,5863,0
2021-10-06,366,799,1839,370,1241,728,601,5944,0
2021-10-07,411,858,1797,361,1003,694,481,5605,0
2021-10-08,378,935,1766,330,920,632,501,5462,0
2021-10-09,15,570,869,0,613,177,199,2443,1
2021-10-10,0,473,736,0,540,145,123,2017,1
2021-10-11,329,851,1562,268,980,667,425,5082,0
2021-10-12,380,848,1809,399,1099,790,531,5856,0
2021-10-13,390,799,1705,420,1087,779,645,5825,0
2021-10-14,376,867,1950,419,1000,784,555,5951,0
2021-10-15,340,932,1908,392,1083,686,498,5839,0
2021-10-16,65,578,1118,0,351,89,243,2444,1
2021-10-17,0,434,707,0,267,94,152,1654,1
2021-10-18,327,773,1849,420,1044,767,539,5719,0
2021-10-19,407,878,2125,427,1084,744,570,6235,0
2021-10-20,349,861,1918,436,896,766,572,5798,0
2021-10-21,383,840,1828,400,995,787,565,5798,0
2021-10-22,329,1017,1778,351,1127,647,495,5744,0
2021-10-23,0,460,1014,0,583,207,204,2468,1
2021-10-24,0,377,590,0,570,157,132,1826,1
2021-10-25,334,766,1646,387,922,668,567,5290,0
2021-10-26,390,850,1917,392,1164,807,522,6042,0
2021-10-27,402,933,1902,439,1140,815,633,6264,0
2021-10-28,365,890,1975,371,1098,773,473,5945,0
2021-10-29,333,918,2023,304,1136,760,509,5983,0
2021-10-30,42,712,1228,0,699,185,235,3101,1
2021-10-31,0,546,977,0,403,167,119,2212,1
2021-11-01,375,993,1707,360,964,754,562,5715,0
2021-11-02,402,917,2002,374,1081,805,543,6124,0
2021-11-03,405,957,1878,404,1102,875,631,6252,0
2021-11-04,420,899,1826,400,1064,844,512,5965,0
2021-11-05,424,935,1950,375,1034,682,488,5888,0
2021-11-06,45,457,1328,0,490,151,241,2712,1
2021-11-07,0,443,532,0,427,128,149,1679,1
2021-11-08,386,984,1958,374,1045,806,535,6088,0
2021-11-09,368,859,1872,329,1004,838,529,5799,0
2021-11-10,399,1021,1969,351,1062,805,559,6166,0
2021-11-11,255,857,1590,314,760,557,404,4737,0
2021-11-12,325,902,1798,344,1045,466,428,5308,0
2021-11-13,25,701,979,0,639,327,231,2902,1
2021-11-14,0,536,526,0,386,239,154,1841,1
2021-11-15,434,937,1894,430,1095,841,503,6134,0
2021-11-16,392,899,1952,408,1068,888,539,6146,0
2021-11-17,418,865,1912,412,1131,851,568,6157,0
2021-11-18,424,866,1920,358,1084,782,503,5937,0
2021-11-19,380,930,1856,361,952,717,532,5728,0
2021-11-20,43,725,1236,0,701,197,280,3182,1
2021-11-21,0,610,690,0,529,205,141,2175,1
2021-11-22,372,870,1792,313,929,696,380,5352,0
2021-11-23,372,946,1683,373,1002,662,462,5500,0
2021-11-24,307,976,1478,325,974,630,403,5093,0
2021-11-25,12,368,496,0,252,87,226,1441,0
2021-11-25,12,368,496,0,252,87,226,1441,0
2021-11-26,35,701,984,0,603,69,312,2704,0
2021-11-26,35,701,984,0,603,69,312,2704,0
2021-11-27,60,650,1186,0,732,223,231,3082,1
2021-11-28,0,654,706,0,652,210,215,2437,1
2021-11-29,373,918,1666,338,1083,837,483,5698,0
2021-11-30,350,955,1890,363,1140,784,499,5981,0
2021-12-01,355,936,1880,396,1165,799,620,6151,0
2021-12-02,410,968,1715,411,1099,764,460,5827,0
2021-12-03,343,1009,1708,364,991,715,446,5576,0
2021-12-04,40,657,1026,0,484,150,138,2495,1
2021-12-05,0,618,616,0,443,152,120,1949,1
2021-12-06,374,822,1726,315,979,703,566,5485,0
2021-12-07,390,838,1820,328,926,779,566,5647,0
2021-12-08,384,874,1866,368,999,810,551,5852,0
2021-12-09,353,761,1605,322,941,686,539,5207,0
2021-12-10,357,899,1773,276,979,630,384,5298,0
2021-12-11,32,638,389,0,500,175,145,1879,1
2021-12-12,0,539,319,0,437,129,133,1557,1
2021-12-13,339,871,1779,380,1066,837,454,5726,0
2021-12-14,330,650,1373,361,888,715,508,4825,0
2021-12-15,390,883,1577,338,924,814,528,5454,0
2021-12-16,388,800,1713,377,1075,735,460,5548,0
2021-12-17,334,980,1754,291,923,642,443,5367,0
2021-12-18,40,648,855,0,497,155,194,2389,1
2021-12-19,0,635,535,0,457,148,116,1891,1
2021-12-20,336,881,1319,281,869,623,383,4692,0
2021-12-21,330,874,1534,336,818,595,454,4941,0
2021-12-22,314,856,1381,308,804,574,457,4694,0
2021-12-23,205,646,1014,198,640,342,309,3354,0
2021-12-24,0,504,406,0,111,65,209,1295,0
2021-12-25,15,341,335,0,205,48,56,1000,1
2021-12-26,0,599,441,0,0,179,0,1219,1
2021-12-27,222,793,1182,195,482,399,258,3531,0
2021-12-28,230,916,1265,210,668,457,342,4088,0
2021-12-29,213,693,1094,189,598,427,254,3468,0
2021-12-30,180,540,898,133,486,292,218,2747,0
2021-12-31,0,499,582,0,285,126,188,1680,0
